border_size=1
usage=map

Gg          , Gg          , Gg          , Gg          , Rr          , Gg          , Gg          , Gg          , Mm          , Mm          , Mm          , Mm          , Mm          , Mm          , Ww          , Mm          , Ww          , Mm          , Ww          , Mm          , Ai          , Mm          , Mm          , Gg          , Gg          , Gg          , Rr          , Gg          , Aa          , Gg          , Aa          , Gg          
Gg          , Aa          , Cud         , Aa          , Rr          , Aa^Vha      , Mm          , Mm          , Mm          , Mm          , Mm          , Mm          , Mm          , Ai          , Ww          , Ww          , Ww^Vm       , Ww          , Ww          , Ww          , Ai          , Ai          , Mm          , Mm          , Mm          , Aa          , Rr          , Aa          , Aa^Vha      , Aa          , Aa          , Gg          
Gg          , Cud         , 3 Kud       , Cud         , Rr          , Aa          , Mm          , Mm          , Mm          , Mm          , Mm          , Mm          , Ds          , Ww          , Ww          , Ww          , Ww          , Ww          , Ww          , Ww          , Ww          , Ww          , Mm          , Mm          , Mm          , Mm          , Rr          , Gg          , Chr         , Aa          , Aa          , Gg          
Gg          , Cud         , Cud         , Cud         , Rr          , Aa          , Ha          , Aa^Fpa      , Aa^Fpa      , Mm          , Mm          , Mm          , Ds          , Ww          , Ww          , Ww          , Ww          , Ww          , Ww          , Ww          , Ww          , Mm          , Mm          , Mm          , Mm          , Mm          , Rr          , Chr         , 2 Khr       , Chr         , Gg          , Aa          
Gg          , Aa          , Aa          , Gg          , Rr          , Ha          , Ha          , Ha          , Ha          , Mm          , Mm          , Mm          , Ds          , Ww          , Ww          , Ww          , Ww          , Ww          , Ww          , Ds          , Ds          , Mm          , Mm          , Mm          , Mm          , Mm          , Rr          , Chr         , Chr         , Chr         , Gg          , Gg          
Gg          , Gg          , Gs^Fp       , Gg^Vh       , Rr          , Ha          , Ha          , Ha          , Ha          , Mm          , Mm          , Mm          , Ds          , Ds          , Ww          , Ww          , Ww          , Ww          , Ds          , Ds          , Mm          , Mm          , Mm          , Mm          , Gg          , Gg          , Rr          , Ha          , Ha          , Gg          , Gg          , Gg          
Gg          , Gs^Fp       , Gs^Fp       , Gg          , Rr          , Gg          , Hh          , Hh          , Hh          , Hh          , Hh          , Mm          , Mm          , Ds          , Ds          , Ww          , Mm          , Ds          , Gg          , Mm          , Mm          , Mm          , Gg          , Gg          , Aa^Fpa      , Ha          , Rr          , Ha          , Ha          , Gg          , Gg          , Gg          
Gg          , Gs^Fp       , Gs^Fp       , Hh          , Gg          , Rr          , Rr          , Hh          , Hh          , Hh          , Hh          , Mm^Vhh      , Mm          , Mm          , Mm          , Ds          , Mm          , Mm          , Gg          , Mm          , Mm          , Gg          , Gg          , Gg          , Ha          , Aa^Fpa      , Rr          , Ha          , Gg          , Gg          , Gg^Vh       , Gg          
Gg          , Hh          , Hh          , Hh          , Hh          , Gg          , Gg          , Rr          , Rr          , Hh          , Hh          , Hh          , Hh          , Mm          , Mm          , Mm          , Mm          , Mm          , Gg          , Mm          , Gg          , Gg          , Gg          , Ha          , Ha          , Ha          , Rr          , Gg          , Gg          , Gg          , Gg          , Gg          
Gg          , Hh          , Hh          , Hh          , Hh          , Gg          , Gg          , Aa          , Gg          , Rr          , Rr          , Hh          , Hh          , Hh          , Mm          , Mm          , Mm          , Mm          , Gg^Vh       , Gg          , Gg          , Gg          , Gg          , Ha          , Rr          , Rr          , Gg          , Gg          , Hh          , Gg          , Mm^Vhh      , Mm          
Gg          , Gg          , Hh          , Hh          , Hh          , Gg          , Gg          , Gg          , Gg          , Gg          , Rr          , Hh          , Hh          , Hh          , Mm          , Mm          , Mm          , Mm          , Gg          , Gg          , Hh          , Gg          , Rr          , Rr          , Hh          , Hh          , Hh          , Hh          , Hh          , Hh          , Mm          , Mm          
Mm          , Mm          , Mm          , Hh          , Mm          , Gg          , Gg          , Gg          , Gg          , Gg          , Rr          , Hh          , Hh          , Hh          , Mm          , Mm          , Gg          , Gg          , Hh          , Hh          , Gg          , Rr          , Gg          , Gg          , Gg          , Hh          , Hh          , Hh          , Hh          , Hh          , Mm          , Mm          
Mm          , Mm          , Mm          , Mm          , Hh          , Hh          , Hh          , Gg          , Gg          , Gg^Vh       , Rr          , Gg          , Gg          , Gg          , Gg          , Gg          , Gg          , Gg          , Hh          , Aa          , Gg          , Rr          , Gg          , Gg          , Hh          , Hh          , Hh          , Hh          , Mm          , Mm          , Mm          , Mm          
Mm          , Mm          , Mm          , Mm          , Hh          , Hh          , Hh          , Hh          , Hh          , Gg          , Rr          , Gg          , Gg          , Gg          , Gg          , Gg          , Hh          , Hh          , Gg          , Gg          , Gg          , Rr          , Hh          , Hh          , Hh          , Hh          , Hh          , Mm          , Mm          , Mm          , Mm          , Mm          
Mm          , Mm          , Mm          , Mm          , Mm          , Hh          , Hh          , Hh          , Hh          , Hh          , Hh          , Rr          , Rr          , Gg          , Gg          , Gg          , Gg          , Hh          , Gg          , Gg          , Rr          , Rr          , Hh          , Hh          , Hh          , Hh          , Mm          , Mm          , Mm          , Mm          , Mm          , Mm          
Mm          , Mm          , Mm          , Mm          , Mm          , Mm          , Mm          , Hh          , Hh          , Hh          , Hh          , Hh          , Gg          , Rr          , Rr          , Gg          , Gg          , Gg          , Rr          , Rr          , Gg          , Gs^Fp       , Gs^Fp       , Gs^Fp       , Gs^Fp       , Mm          , Mm          , Mm          , Mm          , Mm          , Mm          , Mm          
Mm          , Mm          , Mm          , Mm          , Mm          , Mm          , Mm          , Mm          , Mm          , Hh          , Hh          , Hh          , Gg          , Gg          , Gg          , Rr          , Rr          , Rr          , Gg          , Gg          , Gg          , Hh          , Hh          , Gs^Fp       , Mm          , Mm          , Mm          , Mm          , Mm          , Mm          , Mm          , Mm          
Mm          , Mm          , Mm          , Mm          , Mm          , Mm          , Mm          , Mm          , Mm          , Hh          , Hh          , Hh          , Hh          , Gg          , Gg          , Gg          , Rr          , Gg          , Gg          , Gg          , Gg          , Mm          , Mm          , Mm          , Mm          , Mm          , Mm          , Mm          , Mm          , Mm          , Mm          , Mm          
Mm          , Mm          , Mm          , Mm          , Mm          , Mm          , Mm          , Mm          , Mm          , Mm          , Hh          , Hh          , Hh          , Gg          , Gg          , Gg          , Rr          , Hh          , Hh          , Gg          , Gg          , Mm          , Mm          , Mm          , Mm          , Mm          , Mm          , Mm          , Mm          , Mm          , Mm          , Mm          
Mm          , Mm          , Mm          , Mm          , Mm          , Mm          , Mm          , Mm          , Mm          , Mm          , Hh          , Hh          , Hh^Vhh      , Hh          , Gg          , Gg          , Rr          , Hh          , Hh          , Gg          , Gg          , Mm          , Mm          , Mm          , Mm          , Mm          , Mm          , Mm          , Mm          , Mm          , Mm          , Mm          
Mm          , Mm          , Mm          , Mm          , Mm          , Mm          , Mm          , Mm          , Mm          , Mm          , Mm          , Hh          , Hh          , Hh          , Gg          , Gg          , Rr          , Hh          , Hh          , Gg          , Gg          , Mm          , Mm          , Mm          , Mm          , Mm          , Mm          , Mm          , Mm          , Mm          , Mm          , Mm          
Mm          , Mm          , Mm          , Mm          , Mm          , Mm          , Mm          , Mm          , Mm          , Mm          , Mm          , Hh          , Hh          , Gs^Fp       , Gg          , Gg          , Rr          , Hh          , Hh          , Gg          , Gg          , Mm          , Mm          , Mm          , Mm          , Mm          , Mm          , Mm          , Mm          , Mm          , Mm          , Mm          
Mm          , Mm          , Mm          , Mm          , Mm          , Mm          , Mm          , Mm          , Mm          , Mm          , Mm          , Hh          , Hh          , Gs^Fp       , Hh          , Gg          , Rr          , Gg          , Hh          , Gg          , Gg          , Mm          , Hh          , Mm          , Mm          , Mm          , Mm          , Mm          , Mm          , Mm          , Mm          , Mm          
Mm          , Mm          , Mm          , Mm          , Mm          , Mm          , Mm          , Mm          , Mm          , Mm          , Mm          , Mm          , Mm          , Hh          , Hh          , Hh          , Rr          , Gg          , Gg          , Gg          , Gg^Vh       , Hh          , Hh          , Hh          , Mm          , Mm          , Mm          , Mm          , Mm          , Mm          , Mm          , Mm          
Gg          , Mm          , Mm          , Mm          , Mm          , Mm          , Mm          , Mm          , Mm          , Mm          , Mm          , Mm          , Mm          , Hh          , Hh          , Hh          , Rr          , Gg          , Gg          , Gg          , Gg          , Hh          , Hh          , Hh          , Mm          , Mm          , Mm          , Mm          , Mm          , Mm          , Mm          , Mm          
Gg          , Mm          , Mm          , Mm          , Mm          , Mm          , Mm          , Mm          , Mm          , Mm          , Mm          , Mm          , Hh          , Hh          , Hh          , Hh          , Rr          , Gg          , Gg          , Gg          , Gg          , Mm          , Hh          , Mm          , Mm          , Mm          , Mm          , Mm          , Mm          , Mm          , Mm          , Mm          
Mm          , Mm          , Mm          , Mm          , Mm          , Mm          , Mm          , Mm^Vhh      , Mm          , Mm          , Mm          , Hh          , Hh          , Hh          , Hh          , Gg^Vh       , Rr          , Gg          , Gg          , Gg          , Mm          , Hh          , Hh          , Hh          , Mm          , Mm          , Mm          , Mm          , Mm          , Mm^Vhh      , Mm          , Mm          
Mm          , Mm          , Mm          , Mm          , Mm          , Mm          , Mm          , Mm          , Hh          , Mm          , Hh          , Hh          , Hh          , Hh          , Rr          , Rr          , Gg          , Gs^Fp       , Gs^Fp       , Gg          , Mm          , Hh          , Hh^Vhh      , Hh          , Mm          , Mm          , Mm          , Mm          , Mm          , Mm          , Mm          , Mm          
Mm          , Mm          , Mm          , Mm          , Mm          , Mm          , Hh          , Hh          , Hh          , Hh          , Hh          , Hh          , Rr          , Rr          , Gg          , Gg          , Gg          , Gs^Fp       , Gs^Fp       , Mm          , Mm          , Mm          , Mm          , Mm          , Mm          , Mm          , Mm          , Mm          , Mm          , Mm          , Mm          , Mm          
Mm          , Mm          , Mm          , Mm          , Mm          , Mm          , Hh          , Hh          , Hh          , Hh          , Hh          , Rr          , Hh          , Gg          , Gg          , Gg          , Gg          , Gg          , Mm          , Mm          , Mm          , Mm          , Mm          , Mm          , Mm          , Mm          , Mm          , Mm          , Mm          , Mm          , Mm          , Mm          
Mm          , Mm          , Mm          , Mm          , Mm          , Mm          , Hh          , Hh          , Hh          , Hh          , Gg          , Rr          , Gg          , Gg          , Gg^Vh       , Gg          , Hh          , Hh          , Hh          , Mm          , Mm          , Mm          , Mm          , Mm          , Mm          , Mm          , Mm          , Mm          , Mm          , Mm          , Mm          , Mm          
Mm          , Mm          , Mm          , Mm          , Mm          , Hh          , Hh          , Hh          , Hh          , Hh          , Gg          , Rr          , Gg          , Gg          , Hh          , Hh          , Hh          , Hh          , Hh          , Mm          , Mm          , Mm          , Mm          , Mm          , Mm          , Mm          , Mm          , Mm          , Mm          , Mm          , Mm          , Mm          
Mm          , Mm          , Mm          , Mm          , Mm          , Hh          , Hh          , Hh          , Hh          , Hh          , Gg          , Rr          , Gg          , Hh          , Hh          , Hh          , Hh          , Hh          , Mm          , Mm          , Mm          , Mm          , Mm          , Mm          , Mm          , Mm          , Mm          , Mm          , Mm          , Mm          , Mm          , Mm          
Mm          , Mm          , Mm          , Mm          , Mm          , Hh          , Hh          , Hh          , Hh          , Hh          , Gg          , Rr          , Gg          , Hh          , Hh          , Hh          , Mm          , Mm          , Mm          , Mm          , Mm          , Mm          , Mm          , Mm          , Mm          , Mm          , Mm          , Mm          , Mm          , Mm          , Mm          , Mm          
Mm          , Mm          , Mm          , Mm          , Mm          , Hh          , Ce          , Ce          , Ce          , Hh          , Gg          , Rr          , Gg          , Hh          , Hh          , Hh          , Mm          , Mm          , Mm          , Mm          , Mm          , Mm          , Mm          , Mm          , Mm          , Mm          , Mm          , Mm          , Mm          , Mm          , Mm          , Mm          
Mm          , Mm          , Mm          , Mm          , Hh          , Hh          , Ce          , 1 Ke        , Ce          , Gg          , Rr          , Rr          , Gs^Fp       , Hh          , Hh^Vhh      , Hh          , Mm          , Mm          , Mm          , Mm          , Mm          , Mm          , Mm          , Mm          , Mm          , Mm          , Mm          , Mm          , Mm          , Mm          , Mm          , Mm          
Mm          , Mm          , Mm          , Mm          , Hh^Vhh      , Hh          , Hh          , Ce          , Gg          , Gg          , Rr          , Gg          , Gs^Fp       , Gs^Fp       , Hh          , Hh^Vhh      , Mm          , Mm          , Mm          , Mm          , Mm          , Mm          , Mm          , Mm          , Mm          , Mm          , Mm          , Mm          , Mm          , Mm          , Mm          , Mm          
Mm          , Mm          , Mm          , Mm          , Hh          , Hh          , Hh          , Hh          , Gg          , Gg          , Gg          , Gg          , Hh          , Gs^Fp       , Hh          , Hh          , Mm          , Mm          , Mm          , Mm          , Mm          , Mm          , Mm          , Mm          , Mm          , Mm          , Mm          , Mm          , Mm          , Mm          , Mm          , Mm          
