border_size=1
usage=map

Mm          , Ww          , Mm          , Ww          , Mm          , Gg          , Mm          , Gs          , Re^Uf       , Re^Uf       , Re^Uf       , Re^Uf       , Re^Uf       , Re^Uf       , Re^Uf       , Rr          , Re^Uf       , Re^Uf       , Re^Uf       , Re^Uf       , Re^Uf       , Re^Uf       , Ch          , Gg          , Gg          , Mm          , Mm          , Mm          , Mm          , Gg          , Mm          , Gg          
Gg          , Mm          , Mm          , Mm          , Mm          , Mm          , Mm          , Ch          , Re^Uf       , Re^Uf       , Re^Uf       , Re^Uf       , Re^Uf       , Re^Uf       , Re^Uf       , Re^Uf       , Re^Uf       , Re^Uf       , Re^Uf       , Re^Uf       , Re^Uf       , Re^Uf       , Ch          , Mm          , Mm          , Mm          , Mm          , Gs          , Mm          , Mm          , Mm          , Gg          
Gg          , Mm          , Mm          , Mm          , Mm          , Mm          , Mm          , Ch          , Gs          , Gs          , Gs          , Gs          , Gs          , Gs          , Gs          , Rr          , Gs          , Gs          , Gs          , Gs          , Gs          , Gs          , Ch          , Gs          , Gs          , Mm          , Mm          , Mm          , Mm          , Mm          , Mm          , Gg          
Mm          , Mm          , Mm          , Mm          , Mm          , Mm          , Mm          , Ch          , Gs          , Gs          , Gs          , Gs          , Gg^Vh       , Gs          , Gs          , Rr          , Gs          , Gs          , Gs          , Gs          , Gg^Vh       , Gs          , Ch          , Gs          , Gs          , Mm          , Mm          , Mm          , Mm          , Mm          , Mm          , Mm          
Mm          , Mm          , Mm          , Mm          , Mm          , Mm          , Gs          , Ch          , Gs          , Gs          , Gs          , Gs          , Rr          , Gs          , Gs          , Rr          , Gs          , Gs          , Gs          , Gs          , Rr          , Gs          , Ch          , Gs          , Mm          , Mm          , Mm          , Mm          , Mm          , Mm          , Mm          , Mm          
Mm          , Mm          , Mm          , Mm          , Mm          , Mm          , Gs          , Ch          , Gs          , Gs          , Gs          , Gs          , Gs          , Rr          , Rr          , Rr          , Gs          , Gs          , Rr          , Rr          , Gs          , Gs          , Ch          , Gs          , Mm          , Mm          , Gs          , Mm          , Mm          , Mm          , Mm          , Gg          
Ww          , Mm          , Ww          , Mm          , Mm          , Gs          , Gs          , Ch          , Gs          , Gg^Vh       , Rr          , Gs          , Gs          , Gs          , Ch          , Ch          , Ch          , Rr          , Gs          , Gs          , Gs          , Gs          , Ch          , Gs          , Gs          , Mm          , Mm          , Mm          , Mm          , Mm          , Mm          , Gg          
Gg          , Mm          , Ww          , Mm          , Mm          , Gs          , Gs          , Ch          , Gs          , Gs          , Gs          , Rr          , Rr          , Gs          , Ch          , 2 Kh        , Ch          , Gs          , Gs          , Gs          , Gs          , Gs          , Ch          , Gs          , Gs          , Gs          , Mm          , Mm          , Mm          , Mm          , Mm          , Gg          
Gg          , Mm          , Ww          , Mm          , Gs          , Gs          , Gs          , Ch          , Gs          , Gs          , Gs          , Gs          , Rr          , Rr          , Gs          , Ch          , Rr          , Gs          , Gs          , Gs          , Gs          , Gs          , Ch          , Gs          , Gs          , Gs          , Gs          , Mm          , Ww          , Mm          , Ww          , Gg          
Mm          , Mm          , Ww          , Ww          , Gs          , Gs          , Gs          , Ch          , Gs          , Gs          , Rr          , Rr          , Gs          , Gs          , Gs          , Rr          , Gs          , Rr          , Rr          , Gs          , Gs          , Gs          , Ch          , Gs          , Gs          , Gs          , Gs          , Gs          , Ww          , Ww          , Ww          , Gg          
Mm          , Mm          , Ww          , Ww          , Gs          , Gs          , Gs          , Ch          , Gs          , Rr          , Gs          , Gs          , Gs          , Gs          , Gs          , Rr          , Gs          , Gs          , Gg^Ve       , Gs          , Gs          , Gs          , Ch          , Gs          , Gs          , Gs          , Ds          , Ds          , Ww          , Ww          , Ww          , Gg          
Gg          , Ww          , Ww          , Ww          , Gs          , Gs          , Gs          , Ch          , Gs          , Gg^Wm       , Gs          , Gs          , Gs          , Gs          , Gs          , Rr          , Gs          , Gs          , Gs          , Gs          , Gs          , Gs          , Ch          , Gs          , Gs          , Ch          , Rd          , Ds          , Ds          , Ww          , Ww          , Gg          
Gg          , Ww          , Ww          , Ww          , Gs          , Gs          , Gs          , Ch          , Ch          , Gs          , Ch          , Gs          , Ch          , Gs          , Ch          , Rr          , Ch          , Gs          , Ch          , Gs          , Ch          , Gs          , Ch          , Gs          , Gs          , Gs          , Ds          , Rd          , Rd          , Ww          , Ww          , Gg          
Ww          , Ww          , Ww          , Ww          , Ww          , Ww          , Ww          , Ch          , Ww          , Ch          , Ww          , Ch          , Ww          , Ch          , Ww          , Ch          , Ww          , Ch          , Ww          , Ch          , Ww          , Ch          , Ww          , Ww          , Ww          , Ww          , Ww          , Ww          , Rd          , Ww          , Ww          , Ww          
Ww          , Ww          , Ww          , Ww          , Ww          , Ww          , Ww          , Ww          , Ww          , Ww          , Ww          , Ww          , Ww          , Ww          , Ww          , Ww^Bw|      , Ww          , Ww          , Ww          , Ww          , Ww          , Ww          , Ww          , Ww          , Ww          , Ww          , Ww          , Ww          , Rd          , Ww          , Ds          , Ds          
Gs          , Ww          , Re^Gvs      , Re^Gvs      , Re^Gvs      , Ww          , Gg^Vc       , Ww          , Gs          , Ww          , Gs          , Ww          , Gs^Fp       , Ww          , Gs          , Ww^Bw|      , Gs^Vht      , Ww          , Gs          , Ww          , Gs          , Ww          , Gs          , Ww          , Gs          , Ww          , Ds          , Ds          , Rd          , Ds          , Ds          , Gs          
Re^Gvs      , Re^Gvs      , Re^Gvs      , Re^Gvs      , Re^Gvs      , Re^Gvs      , Re^Gvs      , Gs          , Gs          , Gs          , Gs^Fp       , Gs^Fp       , Gs          , Gs^Fp       , Gs^Fp       , Gs          , Gs          , Gs          , Gs          , Gs          , Gs          , Gs          , Gs          , Gs          , Gs          , Ds          , Ds          , Ds          , Rd          , Ds          , Ds          , Gs          
Re^Gvs      , Re^Gvs      , Re^Gvs      , Re^Gvs      , Re^Gvs      , Re^Gvs      , Re^Gvs      , Gs          , Gs^Fp       , Gs          , Gs          , Gs          , Gs^Fp       , Gs^Fp       , Gs^Fp       , Gs          , Gs          , Gs          , Gs          , Gs          , Gs          , Gs          , Gs          , Gs          , Gs          , Gs          , Ds          , Ds          , Rd          , Ds          , Ds          , Gs          
Re^Gvs      , Re^Gvs      , Re^Gvs      , Re^Gvs      , Re^Gvs      , Re^Gvs      , Gs          , Gs          , Gs          , Gs^Fp       , Gs          , Gs          , Gs^Fp       , Gs          , Gs^Fp       , Gs          , Gs          , Gs          , Gs          , Gs          , Gs^Fp       , Gs^Fp       , Gs^Fp       , Gs^Fp       , Gs          , Gs          , Ds          , Ds          , Rd          , Ds          , Gs          , Gs          
Re^Gvs      , Re^Gvs      , Re^Gvs      , Re^Gvs      , Gs          , Gs          , Gs          , Gs          , Gs          , Gs          , Gs          , Gs^Fp       , Gs^Vht      , Gs          , Gs          , Gs          , Gs          , Gs          , Gs^Fp       , Gs^Fp       , Gs          , Gs^Fp       , Gs          , Gs          , Gs          , Gs          , Gs          , Ds          , Gs          , Gs          , Gs          , Gs          
Gs          , Re^Gvs      , Gs          , Gs          , Gs          , Gs          , Gs          , Gs          , Gs          , Gs          , Gs          , Gs          , Gs          , Gs          , Gs          , Gs          , Gs          , Gs^Fp       , Gs^Fp       , Gs          , Gs^Fp       , Gs^Fp       , Gs          , Gs          , Gs          , Gs          , Gs          , Gs          , Gs          , Gs          , Gs          , Gs          
Gs          , Gs          , Gs          , Gs          , Gs          , Gs          , Gs          , Gs          , Gs          , Gs          , Gs          , Gs          , Gs          , Gs          , Gs          , Gs          , Gs          , Gs^Fp       , Gs^Fp       , Gs          , Gs          , Gs          , Gs          , Gs          , Gs^Vht      , Gs          , Gs          , Gs          , Gs          , Gs          , Gs          , Gs          
Gs          , Gs          , Gs          , Gs          , Gs          , Gs          , Gs          , Gs          , Gs          , Gs          , Gs          , Gs          , Gs          , Gs          , Gs          , Gs          , Gs          , Gs          , Gs          , Gs          , Gs          , Gs          , Gs          , Gs          , Gs          , Gs          , Gs          , Gs          , Gs          , Gs          , Gs          , Gs          
Gs          , Gs          , Gs          , Gs          , Gs          , Gs          , Gs          , Gs          , Gs          , Gs          , Gs          , Gs          , Gs          , Gs          , Gs          , Gs          , Gs          , Gs          , Gs          , Gs          , Gs          , Gs          , Gs          , Gs          , Gs          , Gs          , Gs          , Gs          , Gs          , Gs          , Gs          , Gs          
Gs          , Gs          , Gs          , Gs          , Gs          , Gs          , Gs          , Gs          , Gs          , Gs          , Gs          , Gs          , Gs          , Gs          , Gs          , Gs          , Gs          , Gs          , Gs          , Gs          , Gs          , Gs          , Gs          , Gs          , Gs          , Gs          , Gs          , Gs          , Gs          , Gs          , Gs          , Gs          
Gs          , Gs          , Gs          , Gs          , Gs          , Gs          , Gs          , Gs          , Gs^Fp       , Gs          , Gs          , Gs          , Gs^Fp       , Gs          , Gs          , Gs          , Gs          , Ce          , Ce          , Gs          , Gs          , Gs          , Gs          , Gs          , Gs          , Gs          , Gs          , Gs          , Gs          , Gs          , Gs          , Gs          
Gs          , Gs          , Gs          , Gs          , Gs          , Gs          , Gs^Fp       , Gs^Fp       , Gs          , Gs^Fp       , Gs^Fp       , Gs^Fp       , Gs          , Gs          , Gs          , Gs          , Ce          , Ce          , 1 Ke        , Ce          , Gs          , Gs          , Gs          , Gs          , Gs          , Gs          , Gs          , Gs          , Gs^Fp       , Gs          , Gs          , Gs          
Gs          , Gs          , Gs          , Gs          , Gs          , Gs^Fp       , Gs^Fp       , Gs^Fp       , Gs^Fp       , Gs^Fp       , Gs          , Gs          , Gs          , Gs          , Gs          , Gs          , Gs          , Ce          , Ce          , Ce          , Gs          , Gs          , Gs          , Gs          , Gs          , Gs          , Gs          , Gs          , Gs          , Gs          , Gs          , Gs          
Gs          , Gs          , Gs          , Gs          , Gs          , Gs          , Gs          , Gs^Fp       , Gs          , Gs          , Gs          , Gs          , Gs          , Gs          , Gs          , Gs          , Gs          , Gs          , Gs          , Gs          , Gs          , Gs          , Gs          , Gs          , Gs          , Gs          , Gs          , Gs          , Gs          , Gs          , Gs          , Gs          
Gs          , Gs          , Gs          , Gs          , Gs          , Gs          , Gs          , Gs          , Gs          , Gs          , Gs^Vht      , Gs          , Gs          , Gs          , Gs          , Gs          , Gs          , Gs          , Gs          , Gs          , Gs          , Gs          , Gs          , Gs          , Gs          , Gs          , Gs          , Gs          , Gs          , Gs^Vht      , Gs          , Gs          
Gs          , Gs          , Gs          , Gs          , Gs          , Gs          , Gs          , Gs          , Gs          , Gs          , Gs          , Gs          , Gs          , Gs          , Gs          , Gs          , Gs          , Gs          , Gs          , Gs          , Gs          , Gs          , Gs          , Gs          , Gs          , Gs          , Gs          , Gs          , Gs          , Gs          , Gs          , Gs          
Gs          , Gs          , Gs          , Gs          , Gs          , Gs          , Gs          , Gs          , Gs          , Gs          , Gs          , Gs          , Gs          , Gs          , Gs          , Gs          , Gs          , Gs          , Gs          , Gs          , Gs          , Gs          , Gs          , Gs          , Gs          , Gs          , Gs          , Gs          , Gs          , Gs          , Gs          , Gs          
