border_size=1
usage=map

Gs          , Cud         , Gs          , Gs          , Gs          , Gs          , Gs          , Gs          , Gs          , Gs          , Gs          , Gs          , Gs          , Gs          , Gs          , Gs          , Gs          , Gs          , Ds          , Ds          , Chs         , Ww          , Ww          , Ww          , Ww          , Ww          , Ww          , Ww          , Ww          , Ww          , Ds          , Gs          , Gs          , Gs          , Hh          , Gs          , Gs          , Gs          , Gs          
Gs          , 4 Kud       , Cud         , Cud         , Cud         , Cud         , Gs          , Gs          , Gs          , Gs          , Gs          , Gs^Fp       , Gs          , Ss          , Ss          , Ss          , Ss          , Ss          , Gg          , Chs         , Chs         , Ww          , Ww          , Ww          , Ww          , Ww          , Ww          , Ww          , Ww          , Ds          , Ds          , Gs          , Gs          , Gs          , Hh          , Hh          , Gs          , Gs          , Gs          
Gs          , Cud         , Re^Gvs      , Re^Gvs      , Hh          , Hh          , Gs          , Gs          , Gs          , Gs          , Gs^Fp       , Gs^Fp       , Ss          , Ss          , Ss          , Ss          , Ss          , Ss          , Ds          , Chs         , Ds          , 2 Khs       , Ss          , Ww          , Ss          , Ww          , Ww          , Ww          , Ww          , Ww          , Ds          , Gs          , Hh          , Hh          , Chr         , Hh          , Hh          , Hh          , Gs          
Gs          , Re^Gvs      , Re^Gvs      , Re^Gvs      , Gs          , Gs          , Gs          , Gs          , Gs^Fp       , Gs^Fp       , Gg^Efm         , Gg^Efm         , Gs^Fp       , Gs^Fp       , Gs^Fp       , Gs^Fp       , Ss          , Ss          , Ss          , Ss          , Ss          , Ds          , Ss          , Ss          , Ss          , Ss          , Ww          , Ww          , Ww          , Ww          , Ds          , Gs          , Hh          , Chr         , Khr         , Chr         , Hh          , Hh          , Gs          
Gs          , Re^Gvs      , Re^Gvs      , Re^Gvs      , Gs          , Gs          , Gs          , Gs          , Gs^Fp       , Gs^Fp       , Gs^Fp       , Gs^Fp       , Gs^Fp       , Gs^Fp       , Ss          , Ss          , Ss          , Ss          , Ss          , Ss^Vhs      , Ss          , Ww          , Ss          , Ss          , Ww          , Ww          , Ww          , Ww          , Ww          , Ww          , Ds          , Gs          , Hh          , Chr         , Chr         , Chr         , Gs          , Gs          , Gs          
Gs          , Re^Gvs      , Re^Gvs      , Re^Gvs      , Gs          , Gs          , Gs          , Gs          , Gs          , Gs^Fp       , Gs^Fp       , Gs          , Gs          , Ss          , Ds          , Ss          , Ds          , Ss          , Ss          , Ss          , Ss          , Ss          , Ww          , Ww          , Ss          , Ww          , Ww          , Ww          , Ww          , Ww          , Ds          , Gs          , Gs          , Hh          , Hh          , Hh          , Hh          , Gs          , Gs          
Gs          , Re^Gvs      , Re^Gvs      , Re^Gvs      , Gs          , Gs          , Gs          , Gs          , Gs^Fp       , Gs          , Gs^Fp       , Gs          , Gs^Fp       , Gs^Fp       , Gs          , Ds          , Ds          , Ds          , Ww          , Ww          , Ss          , Ss          , Ww          , Ss^Vm       , Ss          , Ww          , Ww          , Ww          , Ww          , Ds          , Chr         , Gs          , Gs          , Hh          , Gs          , Hh          , Hh          , Gs          , Gs          
Gs          , Re^Gvs      , Gs          , Gs          , Gs          , Gs          , Gs          , Gs          , Gs^Fp       , Gs^Fp       , Gs          , Gs          , Gs^Fp       , Gs^Fp       , Gs          , Ds          , Ds          , Ds          , Ss          , Ww          , Ss          , Ss          , Ss          , Ss          , Ww          , Ww          , Ww          , Ww          , Ww          , Ds          , Ds          , Chr         , Gs          , Gs          , Gs          , Hh          , Gs          , Gs          , Gs          
Gs          , Gs          , Gs          , Gs          , Gs          , Gs          , Gs          , Gs          , Gs          , Gs          , Gs          , Gs^Fp       , Gs          , Gs          , Gs          , Gs          , Gs          , Ds          , Ds          , Ss          , Ww          , Ww          , Ww          , Ww          , Ww          , Ww          , Ww          , Ww          , Ww          , Ds          , Gs          , Gs          , Hh          , Hh          , Hh          , Hh          , Hh          , Gs          , Gs          
Gs          , Gs          , Gs          , Gs          , Gs          , Gs          , Gs          , Gs          , Gs          , Gs          , Gs          , Gs^Fp       , Gs          , Gs          , Gs          , Gs          , Gs          , Ds          , Ds          , Ww          , Ww          , Ww          , Ww          , Ww          , Ww          , Ww          , Ww          , Ww          , Ds          , Ds          , Gs          , Hh          , Gs          , Gs          , Hh          , Gs          , Hh          , Gs          , Gs          
Gs          , Gs          , Ce          , Ce          , Ce          , Gs          , Gs          , Gs          , Gs          , Gs          , Gs          , Gs          , Gs          , Gs          , Gs          , Gs          , Ds          , Ds          , Ww          , Ww          , Wwf         , Ww          , Gs^Fp       , Ww          , Gs^Fp       , Ww          , Ww          , Ww          , Ds          , Ds          , Hh          , Hh          , Hh          , Hh          , Gs          , Hh          , Hh          , Gs          , Gs          
Gs          , Gs          , Ke          , 1 Ke        , Ce          , Gs          , Gs          , Gs          , Gs          , Gs          , Gs          , Gs          , Gs          , Gs          , Gs          , Gs          , Ds          , Ww          , Wwf         , Wwf         , Wwf         , Rd          , Rd          , Rd          , Rd          , Wwf         , Wwf         , Ww          , Ww          , Ds          , Hh          , Hh          , Gs          , Hh          , Hh          , Gs          , Hh          , Hh          , Gs          
Gs          , Gs          , Gs          , Ce          , Gs          , Gs          , Gg^Vh       , Gs          , Gs          , Gs          , Gs          , Gs          , Gs          , Gs          , Gs          , Gs          , Ds          , Wwf         , Wwf         , Wwf         , Ww          , Gs^Fp       , Gs^Fp       , Gg^Ve       , Gs^Fp       , Wwf         , Wwf         , Wwf         , Wwf         , Ds          , Gs          , Gs          , Hh          , Hh          , Gs          , Gs          , Hh          , Hh          , Gs          
Gs          , Gs          , Gg^Vh       , Gs          , Gs          , Gs          , Gs          , Gs          , Gs          , Gs          , Gs          , Gs          , Gs          , Gs          , Gs          , Gs          , Gs          , Ds          , Ww          , Ww          , Ww          , Ww          , Ww          , Gs^Fp       , Ww          , Ww          , Ww          , Wwf         , Wwf         , Ds          , Gs          , Gs          , Gs          , Gs          , Gs          , Hh          , Hh          , Gs          , Gs          
Gs          , Gs          , Gs          , Gs          , Gs          , Gs          , Gs          , Gs          , Gs          , Gs          , Gs          , Gs          , Gs          , Gs          , Gs          , Gs          , Gs          , Ds          , Ds          , Ww          , Ww          , Ww          , Ww          , Ww          , Ww          , Ww          , Ww          , Ww          , Ds          , Ds          , Gs          , Chr         , Hh          , Gs          , Gs          , Gs          , Chr         , Chr         , Gs          
Gs          , Hh          , Gs          , Gs          , Gs          , Gs          , Gs          , Gs          , Gs          , Gs          , Gs          , Gs          , Gs          , Gs          , Gs          , Gs          , Gs          , Gs          , Ds          , Ww          , Ww          , Ww          , Ww          , Ww          , Ww          , Ww          , Ww          , Ds          , Ds          , Gs          , Gs          , Gs          , Gs          , Hh          , Hh          , Gs          , Chr         , Khr         , Gs          
Gs          , Hh          , Hh          , Gs          , Gs          , Gs          , Gs          , Gs          , Gs          , Gs          , Gs          , Gs          , Gs          , Gs          , Gs          , Gs          , Gs          , Gs          , Ds          , Ww          , Ww          , Ww          , Ww          , Ww          , Ww          , Ww          , Ww          , Ww          , Ds          , Gs          , Hh          , Hh          , Hh          , Gs          , Gs          , Chr         , Chr         , Chr         , Gs          
Hh          , Hh          , Hh          , Gs          , Gs          , Gs          , Gs          , Gs          , Gs          , Gs          , Gs^Fp       , Gs          , Gs^Fp       , Gs          , Gs^Fp       , Gs          , Gs          , Gs          , Ds          , Ww          , Ww          , Ww          , Ww          , Ww          , Ww          , Ww          , Ww          , Ds          , Ds          , Gs          , Hh          , Hh          , Gs          , Hh          , Hh          , Gs          , Hh          , Hh          , Gs          
Hh          , Hh          , Gs          , Hh          , Gs          , Gs          , Gs          , Gs          , Gs          , Gs^Fp       , Gs          , Gs          , Gs^Fp       , Gs^Fp       , Gs^Fp       , Gs          , Gs          , Gs          , Ds          , Ww          , Ww          , Ww          , Ww          , Ww          , Ww          , Ww          , Ww          , Ww          , Ds          , Gs          , Hh          , Gs          , Hh          , Hh          , Gs          , Hh          , Hh          , Hh          , Gs          
Hh          , Hh          , Hh          , Hh          , Gs          , Gs          , Gs          , Gs          , Gs          , Gs^Fp       , Gs          , Gs          , Gs^Fp       , Gs^Fp       , Gs          , Gs          , Ss^Vhs      , Gs          , Ds          , Ds          , Ds          , Ww          , Ww          , Ww          , Ww          , Ww          , Ww          , Ww          , Ds          , Gs          , Hh          , Gs          , Hh          , Gs          , Hh          , Gs          , Hh          , Gs          , Gs          
Gs          , Hh          , Gs          , Gs          , Gs          , Gs          , Gs          , Gs          , Gs^Fp       , Gs          , Gs^Fp       , Gs^Fp       , Gs          , Gs^Fp       , Gs^Fp       , Gs          , Ss          , Ss          , Ss          , Ss          , Ss          , Ww          , Ww          , Ww          , Ww          , Ww          , Ww^Vm       , Ww          , Ds          , Gs          , Gs          , Gs          , Hh          , Gs          , Hh          , Hh          , Hh          , Gs          , Gs          
Gs          , Gs          , Gs          , Gs          , Gs          , Gs^Fp       , Gs          , Gs          , Gs^Fp       , Gs^Fp       , Gs^Fp       , Gs          , Gs          , Gs          , Gs^Fp       , Gs          , Ss          , Ss          , Ss          , Ss          , Ss          , Ww          , Ww          , Ww          , Ww          , Ww          , Ww          , Ww          , Ds          , Gs          , Chr         , Gs          , Hh          , Hh          , Gs          , Gs          , Hh          , Hh          , Gs          
Gs          , Gs          , Gs          , Gs          , Gs          , Gs          , Ss          , Gs          , Ss          , Ss          , Gs          , Gs          , Ss          , Gs          , Gs^Fp       , Gs          , Ss          , Ds          , Ds          , Ds          , Ss          , Ss          , Ss          , Ww          , Ww          , Ww          , Ww          , Ww          , Ds          , Chr         , Khr         , Chr         , Hh          , Gs          , Gs          , Gs          , Hh          , Gs          , Gs          
Gs          , Gs          , Gs^Fp       , Gs          , Gs          , Gs          , Gs          , Ss          , Gs          , Ss          , Ss          , Ss          , Gs          , Ss          , Gs          , Gs^Fp       , Ss          , Ds          , Ds          , Ss          , Ss          , Ss          , Ss          , Ss          , Ss          , Ss          , Ss          , Ss          , Ww          , Chr         , Chr         , Chr         , Hh          , Hh          , Hh          , Hh          , Gs          , Gs          , Gs          
Gs          , Gs          , Gs          , Gs^Fp       , Gs          , Gs          , Gs          , Gs          , Gs          , Gs          , Gs^Fp       , Gs^Fp       , Gs          , Gs          , Gs          , Ss          , Chs         , Ds          , Ds          , Ds          , Ss          , Ss          , Ss          , Ss          , Ss          , Ss          , Ss          , Ss          , Ss          , Ss          , Gs          , Gs          , Gs          , Hh          , Hh          , Hh          , Hh          , Hh          , Gs          
Gs          , Gs          , Gs          , Gs          , Gs          , Gs^Fp       , Gs^Fp       , Gs          , Gs^Fp       , Gs^Fp       , Gs          , Ss          , Ss          , Gs          , Ss          , Chs         , 3 Khs       , Chs         , Chw         , Ss          , Ww          , Ss          , Ss          , Ss          , Ss          , Ss          , Ss          , Ss          , Ss          , Ss          , Ss          , Gs          , Gs          , Gs          , Gs          , Hh          , Gs          , Gs          , Gs          
Gs          , Gs          , Gs          , Gs          , Gs          , Gs          , Gs          , Gs^Fp       , Gs          , Gs          , Gs          , Gs          , Gs          , Ss          , Gg          , Ss          , Gg          , Ds          , Gg          , Ww          , Ww          , Ww          , Ww          , Ww          , Ww          , Ww          , Ww          , Ss          , Gg          , Ss          , Gs          , Gs          , Gs          , Gs          , Gs          , Gs          , Gs          , Gs          , Gs          
