border_size=1
usage=map

Gs          , Gs          , Gs          , Gs          , Gs          , Gs          , Gs          , Gs          , Gs          , Gs          , Ss          , Gs          , Gs          , Gs          , Ss          , Gs          , Ss          , Gs          , Ss          , Gs          , Ss          , Ss          , Ss          , Gs          , Gs          , Gs          , Gs          , Gs          , Gs          , Ss          , Ss          , Gs          , Gs          , Gs          , Gs          , Gs          , Gs          , Gs          , Gs          , Gs          , Gs          , Gs          , Gs          , Gs          , Gs          , Gs          , Gs          , Gs          , Gs          , Gs          , Gs          , Gs          , Gs          , Gs          , Gs          , Gs          
Gs          , Dd          , Dd          , Gs          , Gs          , Gs          , Ss^Vm       , Ss          , Ss          , Ss          , Aa          , Ss          , Ss          , Ss          , Ai          , Ss          , Wwf         , Wwf         , Ss          , Ss          , Chs         , Ss          , Ss          , Gs          , Ss          , Ss          , Gs^Fp       , Ss          , Ss          , Ss          , Ss          , Ss          , Ds          , Gs          , Gs          , Gs          , Gs          , Gs          , Gs          , Gs          , Gs          , Gs          , Hh          , Hh          , Gs          , Gs          , Hh          , Gs          , Gs          , Gs          , Gs          , Gs          , Gs          , Gs          , Ss          , Ss          
Gs          , Gs          , Aa          , Dd          , Aa          , Gs          , Gs          , Ss          , Gs          , Ss          , Ai          , Ha          , Ai          , Ss          , Ai          , Ai          , Ss          , Ss          , Ss          , Chs         , 3 Khs       , Chs         , Ss          , Ss          , Ss          , Aa^Fpa      , Ss          , Gs^Fp       , Ss          , Ss          , Ha          , Ss          , Ss          , Ds          , Ss^Vhs      , Gs          , Aa          , Gs          , Aa          , Gs          , Gs          , Gs          , Gs          , Gs          , Gs          , Gs          , Gs          , Hh          , Aa          , Gs          , Aa          , Gs          , Gs          , Gs          , Gs          , Ss          
Gs          , Aa          , Aa          , Aa          , Aa          , Gs          , Gs          , Gs          , Gs          , Ds          , Aa          , Ha          , Ss          , Ai          , Ai          , Ha          , Ss          , Ss          , Ss          , Chs         , Chs         , Chs         , Ss          , Ss          , Ss          , Ss          , Ds          , Chs         , 5 Khs       , Aa          , Ss          , Ss          , Ss          , Ss          , Aa          , Aa          , Gs          , Gs          , Gs          , Gs          , Hh          , Hh          , Gs          , Gs          , Ha          , Hh          , Ha          , Ha          , Hh          , Gs          , Gs          , Gs          , Aa          , Gs          , Re^Gvs      , Gs          
Gs          , Gs          , Gs          , Ss          , Ss          , Aa          , Gs          , Aa^Fpa      , Gs          , Ss^Vm       , Ss          , Ss          , Ds          , Ss          , Ha          , Gs^Fp       , Ai          , Ss          , Ss^Bw/      , Ss^Bw/      , Ss          , Ss^Bw|      , Ha          , Ai          , Ai          , Ss          , Ss          , Chs         , Chs         , Ss          , Ha          , Ds          , Ds          , Ds          , Aa          , Gs          , Gs          , Hh          , Gs          , Gs          , Aa          , Hh          , Hh          , Hh          , Gs          , Aa          , Gs          , Gs          , Hh          , Ha          , Hh          , Gs          , Re^Gvs      , Aa          , Re^Gvs      , Gs          
Gs          , Gs          , Gs          , Ss          , Aa          , Aa          , Gs          , Gs          , Ss          , Gs          , Gs          , Ss          , Ss          , Ds          , Aa^Fpa      , Gs^Fp       , Gs^Fp       , Ss          , Wwf         , Ww^Vm       , Aa          , Ai          , Ha          , Ai          , Ss          , Ss          , Ss          , Gs^Fp       , Ss          , Ss          , Ss          , Ds          , Ss          , Gs          , Hh          , Gs          , Ss          , Aa          , Gs          , Gs          , Aa          , Hh          , Gs          , Ha          , Ha          , Gs          , Gg          , Aa          , Hh          , Ha          , Re^Gvs      , Re^Gvs      , Re^Gvs      , Re^Gvs      , Re^Gvs      , Re^Gvs      
Ha          , Gs          , Ha          , Gs          , Gs          , Gs          , Ss          , Ss          , Dd          , Gs          , Ss          , Ss          , Ss          , Ss          , Ss          , Aa^Fpa      , Ss          , Ss          , Ss          , Ss          , Aa          , Ai          , Ss^Vhs      , Ai          , Ss          , Aa^Fpa      , Ai          , Ss          , Ss          , Ss^Vhs      , Ss          , Ss          , Ss          , Dd          , Ww          , Aa          , Ds          , Ss          , Aa          , Ss          , Gs          , Gs          , Gs          , Ha          , Gg          , Hh          , Gg          , Ha          , Re^Gvs      , Re^Gvs      , Re^Gvs      , Re^Gvs      , Re^Gvs      , Re^Gvs      , Aa          , Gs          
Gs          , Ha          , Hh          , Ha          , Ha          , Ha          , Ss          , Ss          , Hh          , Gs          , Gs          , Gs          , Ss          , Ss          , Ss          , Ss          , Ds          , Ss          , Ww          , Ss          , Ss          , Aa          , Ss          , Ss          , Ss          , Ai          , Ha          , Ai          , Ss          , Ds          , Gs          , Ww          , Ww          , Ww          , Gs          , Hh          , Ds          , Ds          , Gs          , Gs          , Gs          , Aa          , Ss          , Hh          , Gs          , Gg          , Re^Gvs      , Re^Gvs      , Aa          , Re^Gvs      , Re^Gvs      , Re^Gvs      , Aa          , Aa          , Re^Gvs      , Gs          
Gs          , Gs          , Ha          , Gs          , Gs          , Gs          , Ss          , Ss          , Ss          , Hh          , Gs          , Ww          , Ww          , Gs          , Ds          , Ds          , Ss          , Ww          , Ss          , Ss          , Ds          , Ss          , Ss          , Wwf         , Ss          , Ss          , Ai          , Ss          , Ds          , Gs          , Ss          , Gs          , Hh          , Ww          , Ss          , Ds          , Gs          , Ss          , Hh          , Hh          , Gs          , Ds          , Ds          , Gg          , Aa          , Re^Gvs      , Re^Gvs      , Aa          , Re^Gvs      , Re^Gvs      , Re^Gvs      , Re^Gvs      , Mm^Vhh      , Re^Gvs      , Xu          , Gs          
Gs          , Gs          , Ha          , Gs          , Gs          , Hh          , Gs          , Ss          , Ha          , Gs          , Gs          , Gs          , Gs          , Ww          , Hh          , Ww          , Ww          , Ss          , Ss          , Gs          , Aa          , Gs^Fp       , Ss          , Ss          , Wwf         , Ss          , Ss          , Aa          , Ss          , Gs          , Dd          , Hh          , Ha          , Hh          , Hh          , Hh          , Hh          , Gs          , Gs          , Gs          , Gg          , Gg          , Gs          , Ss          , Gs          , Gs          , Xu          , Xu          , Xu          , Xu          , Mm          , Mm          , Mm          , Mm          , Mm          , Mm          
Gs          , Gs          , Gs          , Hh          , Ha          , Hh          , Gs          , Gs          , Gs          , Ha          , Ha          , Ha          , Ha          , Ha          , Ha          , Gs          , Hh          , Ww          , Ss          , Ss          , Ss          , Ss          , Ss          , Gs          , Ss          , Ss          , Gs^Fp       , Gs          , Ss          , Gs          , Ha          , Ha          , Ha          , Hh          , Ds          , Hh          , Gs          , Hh          , Gs          , Gs          , Aa          , Aa          , Aa          , Aa          , Gs          , Xu          , Mm          , Xu          , Mm          , Mm          , Mm          , Mm          , Mm          , Mm          , Mm          , Mm          
Gs          , Gs          , Gs          , Hh          , Ha          , Hh          , Hh          , Gs          , Gs          , Hh          , Ha          , Gs          , Gs          , Ha          , Gs          , Gs          , Gs          , Hh          , Ss          , Ss          , Ss          , Gs          , Ss          , Ss          , Ha          , Ss          , Hh          , Ha          , Gs          , Ha          , Ss          , Ha          , Ha          , Ss          , Ds          , Ss          , Ha          , Hh          , Gs          , Gs          , Aa          , Gs          , Aa          , Aa          , Mm          , Mm          , Mm^Vhh      , Mm          , Mm          , Mm          , Mm^Xm       , Mm          , Mm^Xm       , Mm          , Mm^Xm       , Gs          
Gs          , Gs          , Gs          , Gs          , Gg          , Gs          , Gs          , Gs          , Gs          , Hh          , Hh          , Gs          , Ha          , Ss          , Ha          , Gs          , Gs          , Hh          , Ss          , Ds          , Ss          , Ss          , Ds          , Ds          , Ss          , Ha          , Ss          , Hh          , Ww          , Hh          , Hh          , Ha          , Ha          , Ds          , Hh          , Ha          , Gs          , Gs          , Gg          , Gs          , Aa          , Aa          , Rr          , Aa          , Xu          , Mm          , Mm          , Mm          , Gg          , Mm          , Mm^Xm       , Mm^Xm       , Mm^Xm       , Mm^Xm       , Mm^Xm       , Mm^Xm       
Gs          , Gs          , Gs          , Gg          , Gs          , Gg          , Gg          , Gs          , Gs          , Hh          , Ss          , Gs          , Ha          , Ss          , Hh          , Ha          , Hh          , Hh          , Ds          , Ss          , Ss          , Ss          , Ss          , Hh          , Gs          , Gs          , Hh          , Ss          , Hh          , Gs          , Hh          , Hh          , Ha          , Ha          , Hh          , Hh          , Gs          , Gs          , Gg          , Gs          , Gs          , Gs          , Aa          , Xu          , Rr          , Mm          , Mm          , Gg          , Mm^Vhh      , Mm^Xm       , Mm^Xm       , Mm^Xm       , Mm^Xm       , Mm^Xm       , Mm^Xm       , Mm^Xm       
Gs          , Gs          , Gs          , Gs          , Gs          , Gs          , Gs          , Gg          , Gs          , Gs          , Ss          , Gs          , Hh          , Ha          , Gs          , Hh          , Gs          , Ds          , Ss          , Ss          , Ss          , Ss          , Ss          , Gs          , Ss          , Gs          , Ss          , Hh          , Gs          , Ss          , Ha          , Ha          , Ha          , Gs          , Gs          , Gs          , Gs          , Ha          , Gg          , Gg^Ve       , Gs          , Gs          , Aa          , Xu          , Rr          , Rr          , Mm          , Gg          , Mm^Xm       , Mm^Xm       , Mm^Xm       , Mm^Xm       , Mm^Xm       , Mm^Xm       , Mm^Xm       , Mm^Xm       
Gs          , Gs          , Ch          , Ch          , Ch          , Gs          , Gs          , Gg          , Gs          , Ss          , Ss          , Gs          , Gs          , Gs          , Hh          , Hh          , Ds          , Ds          , Ds          , Ds          , Ds          , Ss          , Aa^Fpa      , Aa^Fpa      , Ss          , Gs          , Ss          , Gs          , Gs          , Gs          , Gg^Vc       , Gs          , Rd          , Gs          , Gs          , Gs          , Rd          , Ha          , Rd          , Gs          , Rd          , Gg          , Gs          , Mm^Vhh      , Mm          , Rr          , Mm^Xm       , Gg          , Mm^Xm       , Mm^Xm       , Cud         , Cud         , Mm^Xm       , Mm^Xm       , Mm^Xm       , Mm^Xm       
Gs          , Gs          , Ch          , 1 Khr       , Ch          , Gs          , Gs          , Gg          , Gs          , Ss          , Gs          , Gs          , Rd          , Rd          , Rd          , Gs          , Rd          , Ds          , Ds          , Ds          , Re          , Ss          , Rd          , Aa^Fpa      , Aa^Fpa      , Gs          , Rd          , Gs          , Rd          , Gs          , Rd          , Rd          , Gs          , Rd          , Rd          , Rd          , Gs          , Ha          , Hh          , Rd          , Gg          , Rd          , Rd          , Mm          , Cud         , Cud         , Cud         , Mm^Xm       , Mm^Xm       , Cud         , Cud         , Kud         , Ql          , Mm^Xm       , Mm^Xm       , Mm^Xm       
Gs          , Gs          , Gs          , Ch          , Gs          , Gs          , Gs          , Gg          , Gs          , Gs          , Gs          , Rd          , Gs          , Gs          , Gs          , Rd          , Ss          , Rd          , Gs          , Re          , Hh          , Re          , Gs          , Aa^Fpa      , Gs^Fp       , Aa^Fpa      , Gs          , Rd          , Gs          , Rd          , Gs          , Gs          , Aa          , Aa          , Aa          , Gs          , Gs          , Ha          , Hh          , Gs          , Gs          , Gg          , Gs          , Mm          , Cud         , 2 Kud       , Cud         , Mm^Xm       , Mm^Xm       , Cud         , Cud         , Cud         , Mm^Xm       , Mm^Xm       , Mm^Xm       , Mm^Xm       
Gs          , Gs          , Gs          , Gs          , Gs          , Gs          , Gs          , Gs          , Gs          , Gs          , Gg^Vh       , Gs          , Gs          , Ss          , Gs          , Gs          , Gs          , Gs          , Gs          , Ss          , Gg^Ve       , Gs          , Gg          , Gs          , Gs^Fp       , Gs^Fp       , Gs          , Gs          , Ww          , Gs          , Gs          , Aa          , Aa          , Hh          , Aa          , Gs          , Hh          , Hh          , Gs          , Gs          , Gs          , Gg          , Aa          , Aa          , Cud         , Cud         , Cud         , Gg          , Mm^Xm       , Mm^Xm       , Mm^Xm       , Mm^Xm       , Mm^Xm       , Mm^Xm       , Mm^Xm       , Mm^Xm       
Gs          , Gs          , Gs          , Gs          , Gs          , Gs          , Gs          , Aa          , Gs          , Gs          , Ss          , Gs          , Gg          , Gs          , Gs          , Gs          , Gs          , Gs          , Hh          , Hh          , Hh          , Gs          , Gs          , Gg          , Gs          , Hh          , Gs          , Ww          , Ww          , Ww          , Ww          , Gs          , Gs          , Gs          , Aa          , Gs          , Hh          , Gs          , Gs          , Gs          , Gs          , Gg          , Gs          , Aa          , Aa          , Mm          , Mm          , Mm          , Mm          , Mm^Xm       , Mm^Xm       , Mm^Xm       , Mm^Xm       , Mm^Xm       , Mm^Xm       , Mm^Xm       
Gs          , Gs          , Aa          , Gs          , Gs          , Gs          , Gs          , Gs          , Gs          , Aa          , Gs          , Gg          , Gg          , Gs          , Gs          , Ds          , Ds          , Ds          , Ha          , Re          , Ha          , Hh          , Ha          , Gs          , Ha          , Gs          , Gs          , Ww          , Ww          , Ww          , Ww          , Gs          , Gs          , Gs          , Gs          , Gs          , Gs          , Gs          , Gg^Ve       , Gs          , Ha          , Gs          , Gs          , Gs          , Gs          , Mm          , Mm^Vhh      , Mm          , Mm          , Mm          , Mm          , Mm^Xm       , Mm^Xm       , Mm^Xm       , Mm^Xm       , Gs          
Gs          , Gs          , Gs          , Gs          , Gs          , Gg^Vh       , Aa          , Gs          , Gs          , Gs          , Ss          , Gs          , Gs          , Gs^Fp       , Ss          , Gs          , Gs          , Ha          , Hh          , Ss          , Gs          , Ha          , Hh          , Ha          , Ha          , Gs          , Gs          , Gs          , Gs          , Ww          , Gs          , Gs          , Gs          , Gs          , Hh          , Gs          , Hh          , Gs          , Gs          , Ha          , Hh          , Ha          , Gg          , Gs          , Gs^Fp       , Xu          , Mm          , Mm          , Mm          , Mm          , Mm          , Mm          , Mm          , Mm^Xm       , Mm          , Gs          
Gs          , Gs          , Gs          , Gs          , Gs          , Gs          , Gs          , Gs          , Aa^Fpa      , Ss          , Gs          , Gs          , Gs          , Gs          , Ss^Vm       , Gs          , Dd^Dr       , Dd^Vdt      , Hh          , Hh          , Wwf         , Ha          , Gs^Fp       , Hh          , Ds          , Hh          , Hh          , Ha          , Gs          , Gs          , Ha          , Gs          , Gs          , Gs          , Aa          , Aa          , Gs          , Aa          , Ha          , Ha          , Aa          , Gs          , Ha          , Gg          , Gg          , Xu          , Xu          , Gg          , Mm          , Mm          , Mm          , Mm          , Mm          , Mm^Vhh      , Mm          , Gs          
Gs          , Gs          , Gs          , Gs          , Ss          , Ss          , Ss          , Gs          , Gs          , Aa^Fpa      , Gs^Fp       , Gs^Fp       , Aa          , Gs          , Gs          , Hh          , Ds          , Ha          , Ha          , Wwf         , Hh          , Gs          , Ww          , Ds          , Ds          , Ds          , Gs          , Ha          , Gs          , Ha          , Hh          , Hh          , Aa^Fpa      , Gs          , Hh          , Aa          , Gs          , Gs          , Gs          , Gs          , Gs          , Ha          , Gs          , Gs          , Gg          , Gs          , Xu          , Mm^Vhh      , Xu          , Gg          , Mm          , Mm          , Gg          , Mm          , Gg          , Mm          
Gs          , Aa          , Ss          , Ss          , Gg          , Ss          , Gg          , Gs          , Aa          , Gs          , Aa^Fpa      , Gs          , Gs          , Gs          , Gs          , Gs          , Gs          , Ss          , Ha          , Hh          , Hh          , Gs          , Hh          , Ss          , Ds          , Hh          , Hh          , Ha          , Hh          , Hh          , Aa^Fpa      , Aa^Fpa      , Hh          , Ha          , Ha          , Gs          , Aa          , Aa          , Gs          , Hh          , Aa          , Gs          , Gs          , Hh          , Aa          , Gg          , Gg          , Gs          , Aa          , Aa          , Aa          , Xu          , Xu          , Xu          , Xu          , Xu          
Gs          , Gg          , Gs          , Ss          , Aa          , Aa          , Gs          , Aa          , Aa          , Gs          , Aa          , Aa^Fpa      , Gs          , Gs          , Gs          , Gs^Fp       , Hh          , Ha          , Ha          , Ha          , Ss          , Ss          , Ha          , Ds          , Gs          , Ss          , Gs          , Ss          , Ha          , Gs          , Hh          , Aa^Fpa      , Ha          , Ha          , Hh          , Gs          , Aa          , Gs          , Gs          , Gs          , Gs          , Gs          , Ss          , Aa          , Aa          , Ha          , Aa          , Gs          , Aa          , Ss          , Aa          , Gg          , Gg          , Gg          , Gs          , Gs          
Gs          , Gg          , Gs          , Aa          , Aa          , Gs          , Aa          , Aa          , Gg          , Gs          , Aa          , Gs          , Gs          , Gs          , Ha          , Ss          , Ds          , Ai          , Ha          , Ds          , Ss          , Ss          , Gs          , Ha          , Gs          , Ss          , Ha          , Gs          , Hh          , Ss          , Gs          , Ha          , Gs          , Ha          , Gs          , Ha          , Ha          , Gs          , Aa          , Gs          , Ss          , Ss          , Ss          , Gs          , Gs          , Ha          , Ha          , Aa          , Ss          , Ha          , Ha          , Ha          , Aa          , Gs          , Gs          , Gs          
Gs          , Gs          , Gs          , Gs          , Gs          , Gs          , Aa          , Gs          , Gs          , Gs          , Aa          , Gs          , Ss          , Hh          , Ai          , Gs          , Ds          , Ai          , Ha          , Ai          , Ds          , Ss          , Ds          , Ss          , Ss          , Ss          , Gs^Fp       , Gs          , Gs          , Gs          , Ss          , Hh          , Gs          , Hh          , Gs          , Ha          , Gs          , Gs          , Gs          , Gs          , Ss          , Gs          , Ds          , Ss          , Gs          , Aa          , Aa          , Aa          , Ha          , Ha          , Ha          , Ha          , Hh          , Hh          , Gs          , Gs          
Gs          , Gs          , Gg          , Gs          , Gs          , Aa          , Gs          , Gg          , Aa          , Gs          , Aa          , Gs          , Dd^Dr       , Ss          , Aa          , Ai          , Ss          , Gs^Fp       , Chs         , Aa          , Ha          , Ss          , Ss          , Ss          , Ai          , Gs^Fp       , Ss          , Ss          , Ss          , Ss          , Ss          , Gs          , Ss          , Hh          , Gs          , Hh          , Ha          , Ha          , Gs          , Gs          , Ss          , Gs          , Ds          , Ss          , Ss          , Ss          , Gs          , Gs          , Gs          , Gs          , Gs          , Hh          , Hh          , Hh          , Gs          , Gs          
Gs          , Gs          , Gs          , Gs          , Ss          , Gg          , Gs          , Gs          , Gs          , Aa          , Aa          , Ss          , Ss          , Gs          , Ai          , Ai          , Ss          , Ss          , Chs         , 6 Khs       , Ss          , Ha          , Ss          , Aa          , Wwf         , Ai          , Ss          , Ds          , Ss          , Ss          , Gs^Fp       , Gs          , Gs^Fp       , Ss          , Ss          , Gs          , Gs          , Gs          , Ha          , Gs          , Ss          , Ss          , Ds          , Ss          , Ds          , Ss          , Gs          , Ss          , Ss          , Gs          , Gs          , Gs          , Gs          , Hh          , Gs          , Gs          
Gs          , Gs          , Aa          , Gs          , Gs          , Gs          , Gs          , Gs          , Gs          , Ss          , Ss          , Ss          , Ss          , Ss          , Ss          , Ds          , Ss          , Aa          , Hh          , Chw         , Ww          , Ha          , Ss          , Ss          , Wwf         , Ss          , Ss          , Ss          , Aa          , Ai          , Ss          , Ss          , Gs^Fp       , Ss          , Gs          , Gs          , Gs          , Gs          , Gs          , Gs          , Gs          , Ss          , Ss          , Ds          , Ds          , Aa          , Ss          , Ds          , Gs          , Gs          , Ss          , Aa          , Aa          , Gs          , Gs          , Gs          
Gs          , Aa          , Gs          , Aa          , Gs          , Aa          , Aa          , Gs          , Ss          , Gs          , Gs          , Gs          , Gs          , Ds          , Ds          , Ss          , Ss          , Ds          , Ss          , Hh          , Ss          , Ss          , Gs          , Ss^Vm       , Wwf         , Chs         , Ss          , Ds          , Aa          , Ss          , Ss          , Ds          , Ss          , Ss          , Ss          , Gs          , Ww          , Gs          , Gs          , Ss          , Ss          , Gs          , Gs          , Gs          , Aa          , Gs          , Gs          , Gs          , Ss          , Ss          , Ss          , Gs          , Gs          , Gs          , Gs          , Gs          
Gs          , Aa          , Ss          , Gs          , Gs          , Gs          , Aa          , Gs          , Ss          , Ss          , Ss          , Ss          , Gs          , Ds          , Gs^Fp       , Ss          , Ss          , Ss          , Ss          , Ds          , Ss          , Ds          , Gs^Fp       , Ss          , Chs         , Chs         , Chw         , Ww          , Ww          , Ss          , Ss          , Ss          , Ss          , Ds          , Ss^Vhs      , Gs          , Gs          , Gs          , Ss          , Gs          , Gs          , Gs          , Gs          , Gs          , Gs          , Ss          , Gs          , Ds          , Ds          , Ss          , Ss          , Ds          , Gs          , Aa          , Gs          , Gs          
Gs          , Aa          , Aa          , Gs          , Aa          , Aa          , Gs          , Gs          , Gs          , Ss          , Gs          , Gs          , Ss          , Ss^Vhs      , Gs^Fp       , Ss^Vhs      , Ss          , Ww          , Ww          , Ww          , Ww          , Ss          , Ss          , Ss          , Chs         , 4 Khs       , Chw         , Ww          , Gs          , Ss          , Gs          , Ss          , Gs          , Ss          , Gs          , Gs          , Gs          , Ss          , Gs          , Ss          , Gs          , Gs          , Gs          , Gs          , Gs          , Aa          , Gs          , Ds          , Gs          , Gs          , Aa          , Ds          , Aa          , Aa          , Gs          , Gs          
Gs          , Gs          , Aa          , Gs          , Aa          , Aa          , Gs          , Gs          , Gs          , Gs          , Gs          , Gs          , Gs          , Ss          , Gs          , Ss          , Gs          , Gs          , Gs          , Ww          , Gs          , Ww          , Gs          , Gs          , Gs          , Gs          , Gs          , Gs          , Gs          , Gs          , Gs          , Gs          , Gs          , Gs          , Gs          , Gs          , Gs          , Gs          , Gs          , Gs          , Gs          , Gs          , Gs          , Gs          , Gs          , Gs          , Gs          , Gs          , Gs          , Gs          , Gs          , Gs          , Gs          , Gs          , Gs          , Gs          
