border_size=1
usage=map

Mm          , Hh          , Hh          , Gg          , Ha          , Gg          , Ha          , Gg          , Gs          , Hh          , Ha          , Ha          , Ha          , Hh          , Ha          , Hh          , Hh          , Hh          
Mm          , Mm          , Ha          , Hh          , Hh          , Ha          , Hh          , Ha          , Gs          , Hh          , Hh          , Hh          , Ha          , Hh          , Hh          , Ha          , Hh          , Hh          
Mm          , Mm          , Mm          , Mm          , Mm          , Mm          , Mm          , Ha          , Ha          , Gs          , Hh          , Hh          , Mm          , Mm          , Mm          , Ha          , Ha          , Hh          
Mm          , Mm          , Mm          , Mm          , Mm          , Mm          , Hh          , Ha          , Gs          , Gs          , Hh          , Mm          , Mm          , Mm          , Mm          , Mm          , Mm          , Hh          
Mm          , Mm          , Mm          , Mm          , Hh          , Ha          , Ha          , Rd          , Gs          , 1 Gs        , Hh          , Mm          , Mm          , Mm          , Mm          , Mm          , Mm          , Hh          
Mm          , Mm          , Mm          , Ha          , Hh          , Ha          , Hh          , Hh          , Rd          , Gs          , Ha          , Ha          , Mm          , Mm          , Mm          , Mm          , Mm          , Hh          
Mm          , Mm          , Mm          , Mm          , Mm          , Ha          , Ha          , Ha          , Ha          , Hh          , Mm          , Ha          , Mm          , Mm          , Mm          , Mm          , Mm          , Hh          
Mm          , Mm          , Mm          , Mm          , Mm          , Mm          , Mm          , Mm          , Ha          , Mm          , Mm          , Mm          , Mm          , Mm          , Mm          , Mm          , Mm          , Hh          
Mm          , Mm          , Mm          , Mm          , Mm          , Mm          , Mm          , Mm          , Mm          , Mm          , Mm          , Mm          , Mm          , Mm          , Mm          , Mm          , Mm          , Hh          
Mm          , Mm          , Mm          , Mm          , Mm          , Mm          , Mm          , Mm          , Mm          , Mm          , Mm          , Mm          , Mm          , Mm          , Mm          , Mm          , Mm          , Hh          
Hh          , Mm          , Hh          , Mm          , Hh          , Mm          , Hh          , Mm          , Hh          , Mm          , Hh          , Mm          , Hh          , Mm          , Hh          , Mm          , Hh          , Hh          
