border_size=1
usage=map

Gs          , Gs          , Gs          , Gs          , Ha          , Gs          , Mm          , Gs          , Hh          , Gs          , Hh          , Hh          , Hh          , Gs          , Gs          , Gs          , Gs          , Gs          , Gs          , Gs          , Hh          , Gs          , Gs          , Gs          , Gs          , Gg          , Gs          , Hh          , Gs          , Ha          
Gs          , Gs          , Ha          , Ha          , Ha          , Mm          , Mm          , Hh          , Mm          , Mm          , Gs          , Gs          , Aa          , Aa          , Aa          , Aa          , Gs          , Gs          , Gs          , Gs          , Gs          , Gs          , Gs          , Gs          , Gs          , Gs          , Ce          , Gs          , Gs          , Gs          
Gs          , Ha          , Ha          , Hh          , Ha          , Mm          , Mm          , Mm          , Mm          , Dd^Vdt      , Gs          , Aa          , Gs          , Gs          , Hh          , Ha          , Ha          , Ha          , Mm          , Ha          , Ha          , Hh          , Gs          , Gs          , Gs          , Ce          , 3 Ke        , Ce          , Gs          , Gs          
Gs          , Ha          , Hh          , Ha          , Ha          , Mm          , Mm          , Mm          , Ch          , Ch          , Ch          , Aa          , Rp          , Gs          , Ha          , Gs          , Hh          , Mm          , Mm          , Mm          , Mm          , Mm          , Mm          , Mm          , Gs          , Ce          , Ce          , Ce          , Gs          , Gs          
Ha          , Ha          , Gs          , Gs          , Hh          , Gs          , Dd^Vdt      , Gs          , Ch          , 1 Kh        , Ch          , Gs          , Gs          , Ha          , Ha          , Gs          , Hh          , Mm          , Mm          , Mm          , Gs          , Mm          , Aa          , Mm          , Aa          , Mm          , Mm          , Gs          , Aa          , Gs          
Gs          , Hh          , Hh          , Hh          , Hh          , Gs          , Gs          , Gs          , Gs          , Ch          , Gs          , Dd^Vdt      , Gs          , Ha          , Ha          , Ha          , Gs          , Mm          , Hh          , Mm          , Aa          , Gs          , Mm          , Gs          , Mm          , Gs          , Mm          , Gs          , Aa          , Gs          
Gs          , Mm          , Mm          , Mm          , Hh          , Ha          , Gg^Efm         , Gg^Efm         , Ha          , Rd          , Gs          , Gs          , Gs          , Gs          , Ha          , Hh          , Ha          , Mm          , Mm          , Ha          , Mm          , Mm          , Mm          , Mm          , Mm          , Mm          , Gs          , Gs          , Gs          , Gs          
Gs          , Mm          , Ce          , Mm          , Hh          , Gs          , Ha          , Gs          , Rd          , Ha          , Gs          , Ha          , Gs          , Hh          , Hh          , Ha          , Hh          , Mm          , Mm          , Aa          , Hh          , Mm          , Hh          , Gs          , Ha          , Gs          , Gs          , Ha          , Gs          , Gs          
Gs          , Ce          , 2 Ke        , Ce          , Mm          , Ha          , Gs          , Ha          , Gs          , Aa          , Gs          , Ha          , Ha          , Ha          , Hh          , Hh          , Gs          , Ha          , Gs          , Aa          , Ha          , Mm          , Mm          , Gs          , Mm          , Mm          , Mm          , Mm          , Mm          , Ha          
Gs          , Ce          , Ce          , Ce          , Mm          , Mm          , Mm          , Ha          , Gs          , Aa          , Ha          , Hh          , Ha          , Hh          , Ha          , Gs          , Mm          , Mm          , Mm          , Ha          , Mm          , Mm          , Hh          , Mm          , Mm          , Gs          , Hh          , Ha          , Mm          , Gs          
Hh          , Gs          , Hh          , Mm          , Hh          , Mm          , Hh          , Ha          , Hh          , Ha          , Ha          , Ha          , Ha          , Gs          , Mm          , Mm          , Mm          , Hh          , Mm          , Ha          , Mm          , Ha          , Ha          , Gs          , Ha          , Gs          , Gs          , Gs          , Mm          , Gs          
Mm          , Hh          , Hh          , Gg          , Ha          , Gg          , Ha          , Gg          , Gs          , Hh          , Ha          , Ha          , Ha          , Hh          , Mm          , Mm          , Ha          , Hh          , Mm          , Ha          , Ha          , Ha          , Ha          , Mm          , Ha          , Mm          , Gs          , Mm          , Gs          , Gs          
Mm          , Mm          , Ha          , Hh          , Hh          , Ha          , Hh          , Ha          , Gs          , Hh          , Hh          , Hh          , Ha          , Hh          , Mm          , Ha          , Mm          , Mm          , Ha          , Gs          , Ha          , Gs          , Ha          , Ha          , Gs          , Gs          , Gs          , Hh          , Ha          , Gs          
Mm          , Mm          , Mm          , Mm          , Mm          , Mm          , Mm          , Ha          , Ha          , Gs          , Hh          , Hh          , Mm          , Mm          , Mm          , Mm          , Ha          , Hh          , Gs          , Gs          , Hh          , Gs          , Gs          , Gs          , Ce          , Ce          , Ce          , Gs          , Gs          , Gs          
Mm          , Mm          , Mm          , Mm          , Mm          , Mm          , Hh          , Ha          , Gs          , Gs          , Hh          , Mm          , Mm          , Mm          , Mm          , Mm          , Mm          , Hh          , Mm          , Hh          , Mm          , Gs          , Hh          , Aa          , Ce          , 4 Ke        , Ce          , Gs          , Gs          , Gs          
Mm          , Mm          , Mm          , Mm          , Hh          , Ha          , Ha          , Rd          , Gs          , Gs          , Hh          , Mm          , Mm          , Mm          , Mm          , Mm          , Mm          , Mm          , Mm          , Mm          , Mm          , Hh          , Gs          , Aa          , Aa          , Ce          , Gs          , Gs          , Gs          , Gs          
Mm          , Mm          , Mm          , Ha          , Hh          , Ha          , Hh          , Hh          , Rd          , Gs          , Ha          , Ha          , Mm          , Mm          , Mm          , Mm          , Mm          , Mm          , Mm          , Mm          , Mm          , Hh          , Ha          , Gs          , Mm          , Mm          , Gs          , Aa          , Mm          , Gs          
Mm          , Mm          , Mm          , Mm          , Mm          , Ha          , Ha          , Ha          , Ha          , Hh          , Mm          , Ha          , Mm          , Mm          , Mm          , Mm          , Mm          , Mm          , Mm          , Mm          , Mm          , Mm          , Hh          , Gs          , Mm          , Ha          , Aa          , Gs          , Gs          , Gs          
Mm          , Mm          , Mm          , Mm          , Mm          , Mm          , Mm          , Mm          , Ha          , Mm          , Mm          , Mm          , Mm          , Mm          , Mm          , Mm          , Mm          , Mm          , Ha          , Mm          , Hh          , Mm          , Hh          , Gs          , Mm          , Gs          , Mm          , Hh          , Mm          , Gs          
Mm          , Mm          , Mm          , Mm          , Mm          , Mm          , Mm          , Mm          , Mm          , Mm          , Mm          , Mm          , Mm          , Mm          , Mm          , Mm          , Mm          , Hh          , Mm          , Mm          , Mm          , Gs          , Mm          , Mm          , Hh          , Mm          , Mm          , Hh          , Mm          , Gs          
Mm          , Mm          , Mm          , Mm          , Mm          , Mm          , Mm          , Mm          , Mm          , Mm          , Mm          , Mm          , Mm          , Mm          , Mm          , Mm          , Mm          , Mm          , Mm          , Mm          , Mm          , Mm          , Mm          , Mm          , Ha          , Gs          , Mm          , Mm          , Gs          , Gs          
Hh          , Mm          , Mm          , Mm          , Mm          , Mm          , Mm          , Mm          , Mm          , Mm          , Mm          , Mm          , Gs          , Mm          , Gs          , Mm          , Gs          , Mm          , Mm          , Mm          , Mm          , Mm          , Mm          , Ha          , Mm          , Mm          , Mm          , Gs          , Mm          , Gs          
Mm          , Gs          , Mm          , Mm          , Mm          , Mm          , Mm          , Mm          , Mm          , Mm          , Mm          , Mm          , Ha          , Gs          , Gs          , Mm          , Mm          , Ha          , Mm          , Mm          , Mm          , Mm          , Gs          , Mm          , Aa          , Aa          , Mm          , Gs          , Mm          , Gs          
Mm          , Gs          , Mm          , Mm          , Mm          , Mm          , Mm          , Mm          , Mm          , Mm          , Aa          , Gs          , Mm          , Gs          , Gs          , Gs          , Gs          , Gs          , Hh          , Mm          , Mm          , Mm          , Hh          , Mm          , Aa          , Aa          , Mm          , Mm          , Gs          , Gs          
Mm          , Ha          , Mm          , Mm          , Mm          , Mm          , Aa          , Mm          , Aa          , Mm          , Hh          , Mm          , Gs          , Gs          , Ce          , Gs          , Gs          , Mm          , Mm          , Ha          , Mm          , Mm          , Mm          , Mm          , Hh          , Mm          , Mm          , Gs          , Gs          , Gs          
Ha          , Gs          , Hh          , Mm          , Mm          , Mm          , Mm          , Mm          , Gs          , Ha          , Ha          , Gs          , Ha          , Ce          , 5 Ke        , Ce          , Ha          , Gs          , Mm          , Gs          , Gs          , Mm          , Gs          , Mm          , Hh          , Mm          , Ha          , Hh          , Gs          , Gs          
Gs          , Ha          , Aa          , Aa          , Mm          , Mm          , Mm          , Mm          , Mm          , Mm          , Hh          , Gs          , Gs          , Ce          , Ce          , Ce          , Ha          , Gs          , Gs          , Mm          , Hh          , Mm          , Hh          , Mm          , Gs          , Gs          , Aa          , Aa          , Aa          , Gs          
Hh          , Hh          , Aa          , Mm          , Gs          , Mm          , Hh          , Hh          , Mm          , Ha          , Mm          , Mm          , Mm          , Gs          , Gs          , Gs          , Gs          , Ha          , Gs          , Gs          , Mm          , Mm          , Mm          , Ha          , Mm          , Aa          , Aa          , Hh          , Gs          , Aa          
Gs          , Aa          , Aa          , Aa          , Aa          , Ha          , Mm          , Ha          , Gs          , Gs          , Mm          , Mm          , Gs          , Mm          , Mm          , Gs          , Gs          , Gs          , Gs          , Mm          , Mm          , Gs          , Hh          , Hh          , Mm          , Aa          , Hh          , Hh          , Gs          , Gs          
Gs          , Aa          , Gs          , Gs          , Gs          , Mm          , Gs          , Gs          , Gs          , Gs          , Gs          , Gs          , Mm          , Mm          , Gs          , Gs          , Mm          , Gs          , Gs          , Mm          , Gs          , Gs          , Mm          , Gs          , Mm          , Hh          , Gs          , Hh          , Gs          , Hh          
