border_size=1
usage=map

Mm          , Mm          , Mm          , Mm          , Mm          , Mm          , Mm          , Mm          , Mm          , Mm          , Mm          , Mm          , Mm          , Mm          , Mm          , Mm          , Mm          , Mm          , Mm          , Mm          , Mm          , Mm          , Mm          , Mm          , Mm          , Mm          , Mm          , Mm          , Mm          , Mm          , Gs          , Mm          , Mm          
Mm          , Mm          , Mm          , Mm          , Mm          , Mm          , Mm          , Mm          , Mm          , Mm          , Mm          , Mm          , Mm          , Mm          , Mm          , Mm          , Mm          , Mm          , Mm^Vhh      , Mm          , Mm          , Mm          , Mm          , Mm          , Mm          , Mm          , Mm          , Mm          , Mm          , Mm          , Mm          , Mm          , Mm          
Mm          , Mm          , Mm          , Mm          , Mm          , Mm          , Mm          , Mm^Vhh      , Mm          , Mm          , Mm          , Mm          , Mm          , Mm          , Mm          , Mm          , Mm          , Mm          , Mm          , Mm          , Mm          , Mm          , Mm          , Mm          , Mm          , Mm          , Ce          , Ce          , Ce          , Mm          , Gs          , Mm          , Mm          
Mm          , Mm          , Mm          , Mm          , Mm          , Mm          , Mm          , Mm          , Mm          , Ha          , Ha          , Mm          , Mm          , Mm          , Mm          , Mm          , Mm          , Mm          , Mm          , Mm          , Mm          , Mm          , Mm          , Mm          , Ha          , Ha          , Ce          , 1 Ke        , Ce          , Gs          , Ha          , Gs          , Mm          
Mm          , Mm          , Mm          , Mm          , Mm          , Mm          , Mm          , Mm          , Ha          , Ha          , Ha          , Ha          , Ha          , Mm          , Mm          , Ha          , Ha          , Mm          , Ha          , Mm          , Ha          , Ha          , Ha          , Ha          , Gs          , Gs          , Gs          , Ce          , Ha          , Ha          , Ha          , Ha          , Gs          
Mm          , Mm          , Mm          , Mm          , Mm          , Mm          , Ha          , Ha          , Ha          , Ha          , Hh          , Ha          , Hh          , Ha          , Ha          , Ha          , Gs          , Ha          , Ha          , Ha          , Hh          , Ha          , Hh          , Ha          , Gs          , Gs          , Gs          , Gs          , Ha          , Ha^Vhha     , Gs          , Ha          , Gs          
Mm          , Mm          , Mm          , Mm          , Mm          , Ha          , Hh          , Ha          , Hh          , Hh          , Hh          , Hh          , Hh          , Hh          , Gs          , Ha          , Gs          , Gs          , Gs          , Gs          , Gs          , Gs          , Gs          , Gs          , Ha          , Gs          , Ha          , Gs          , Ha          , Ha          , Ha          , Ha          , Gs          
Gs          , Mm          , Mm          , Mm          , Hh          , Hh          , Gs          , Aa^Vea      , Gs          , Gs          , Gs          , Hh          , Gs          , Hh          , Hh          , Gs          , Hh          , Gs          , Ha          , Gs          , Ha          , Gs          , Ha          , Ha          , Ha          , Ha          , Gs          , Ha          , Ha          , Ha          , Ha          , Ha          , Gs          
Gs          , Ha          , Ha          , Hh          , Hh          , Hh          , Gs          , Gs          , Gs          , Gs          , Gs          , Gs          , Gs          , Gs          , Hh          , Hh          , Hh          , Hh^Vhh      , Ha          , Ha          , Mm          , Ha          , Mm          , Ha          , Mm          , Mm          , Mm          , Mm          , Mm          , Mm          , Mm          , Mm          , Gs          
Gs          , Ha          , Gs          , Ha          , Gs          , Gs          , Gs          , Gs          , Gs          , Gs          , Gs          , Gs          , Gs          , Gs          , Gs          , Hh          , Ha          , Ha          , Mm          , Mm          , Mm          , Mm          , Mm          , Mm          , Mm          , Mm          , Mm          , Gs          , Mm          , Mm          , Mm          , Mm          , Gs          
Gs          , Gs          , Gs          , Gs          , Gs          , Gs          , Gs          , Gs          , Gs          , Gs          , Gs          , Gs          , Gs          , Gs          , Gs          , Gs          , Ha          , Ha          , Ha          , Mm          , Mm          , Mm          , Mm          , Gs          , Mm          , Mm          , Mm          , Mm          , Mm          , Mm          , Mm          , Gs          , Gs          
Ss          , Gs          , Gs          , Gs          , Gs          , Gs          , Gs^Vht      , Gs          , Gs          , Gs          , Gs          , Gs          , Gs          , Gs          , Gs          , Gs          , Hh          , Ha          , Ha          , Mm          , Mm          , Mm          , Mm          , Mm          , Mm          , Mm          , Mm^Vhh      , Mm          , Mm          , Gs          , Mm          , Mm          , Mm          
Wo          , Ss          , Ww          , Gs          , Gs          , Gs          , Gs          , Gs          , Gs          , Gs          , Gs          , Gs          , Gs          , Gs          , Hh          , Hh          , Hh          , Hh          , Ha          , Ha          , Mm          , Mm          , Mm          , Mm          , Mm          , Mm          , Mm          , Mm          , Mm          , Gs          , Mm          , Mm          , Gs          
Wo          , Wo          , Ww          , Ww          , Ww          , Gs          , Gs          , Gs          , Gs          , Gs          , Gs          , Gs          , Gs          , Gs          , Hh          , Hh          , Ha          , Ha          , Ha          , Ha          , Mm          , Gs          , Mm          , Mm          , Mm          , Mm          , Mm          , Mm          , Mm          , Mm          , Mm          , Mm          , Gs          
Ww          , Ww          , Ww          , Ww          , Ww          , Ww          , Ww          , Gs          , Gs          , Gs          , Gs          , Gs          , Ch          , Gs          , Gs          , Ha          , Mm          , Ha          , Mm          , Mm          , Mm          , Mm          , Mm          , Mm          , Mm          , Mm          , Mm          , Mm          , Mm          , Mm          , Mm          , Mm          , Gs          
Ww          , Ww          , Ww          , Ww          , Ww          , Ww          , Ww          , Ww          , Ww          , Gs          , Gs          , Chr         , 3 Kh        , Ch          , Hh          , Ha          , Mm          , Mm          , Mm          , Mm          , Mm          , Mm          , Mm          , Mm          , Mm          , Mm          , Mm          , Mm          , Mm          , Mm          , Mm          , Mm          , Gs          
Ww          , Ww          , Ww          , Ww          , Ww          , Ww          , Ww          , Ww          , Ww          , Ww          , Ww          , Chw         , Chr         , Ch          , Ha          , Ha          , Mm          , Mm          , Mm          , Mm          , Mm          , Mm          , Mm          , Mm          , Mm          , Mm          , Mm          , Mm^Vhh      , Mm          , Mm          , Mm          , Hh          , Gs          
Gs          , Ww          , Ww          , Ww          , Ww          , Ww          , Ww          , Ww          , Ww          , Ww          , Ww^Bw/      , Ww^Bw/      , Ww          , Ai          , Ai          , Ha          , Mm          , Mm          , Mm          , Mm          , Mm          , Mm^Vhh      , Mm          , Mm          , Mm          , Mm          , Ha          , Mm          , Hh          , Mm          , Mm          , Mm          , Gs          
Gs          , Gs          , Gs          , Ww          , Ww          , Ww          , Ww          , Ww          , Ww^Bw/      , Ww^Bw/      , Ww          , Ww          , Ww          , Ww          , Ai          , Ha          , Ha          , Mm          , Mm          , Mm          , Mm          , Mm          , Mm          , Mm          , Mm          , Ha          , Ha          , Ha          , Hh          , Mm          , Hh          , Mm          , Gs          
Gs          , Gs          , Gs          , Gs          , Gs          , Ww          , Chw         , Ww^Bw/      , Ww          , Ww          , Ww          , Ww          , Ww          , Ww          , Ai          , Aa          , Ha          , Mm          , Mm          , Mm          , Mm          , Mm          , Ha          , Mm          , Ha          , Ha          , Ha          , Ha          , Hh          , Hh          , Gs          , Hh          , Gs          
Gs          , Gs          , Gs          , Gs          , Gs          , Chw         , 2 Kv        , Chw         , Ww          , Ww          , Ww          , Ww          , Ww          , Ww          , Ww          , Aa          , Ai          , Ha          , Ha          , Ha          , Ha          , Ha          , Ha          , Hh          , Hh          , Hh          , Gs          , Ha          , Hh          , Hh          , Gs          , Gs          , Gs          
Gs          , Gs          , Gs          , Gg^Ve       , Gs          , Chw         , Chw         , Chw         , Gs          , Ww          , Ww          , Ww          , Ww          , Ww          , Ww          , Ww          , Ww          , Ai          , Ai          , Aa          , Aa          , Ha          , Aa          , Ha          , Aa          , Gs          , Gs          , Hh          , Gs          , Gs          , Aa          , Gs          , Gs          
Gs          , Gs          , Gs          , Gs          , Gs          , Gs          , Gs          , Gs          , Gs          , Gs          , Gs          , Ww          , Ww          , Ww          , Ww          , Ww          , Ww          , Ww          , Ww          , Ai          , Ai          , Aa          , Aa          , Aa          , Aa          , Gs          , Gs          , Gs          , Aa          , Aa          , Aa          , Gs          , Gs          
Gs          , Gs          , Gs          , Gs          , Gs          , Gs          , Gs          , Gs          , Gs          , Gs          , Gs          , Gs          , Gs          , Ww          , Ww          , Ww          , Wo          , Ww          , Ww          , Ww          , Ww          , Ai          , Ai          , Aa          , Aa          , Gs          , Gs          , Gs          , Gs          , Gs          , Gs          , Gs          , Gs          
Gs          , Gs          , Gs          , Gs          , Gs          , Gs          , Gs          , Gs          , Gs          , Gs          , Gs          , Gs          , Gs          , Ww          , Ww          , Wo          , Wo          , Wo          , Wo          , Ww          , Ww          , Ai          , Ai          , Aa          , Gs          , Gs          , Gs          , Gs          , Gs          , Gs          , Gs          , Gs          , Gs          
