border_size=1
usage=map

Hh          , Ss          , Hh          , Hh          , Hh          , Hh          , Hh          , Hh          , Hh          , Mm          , Mm          , Mm          , Mm          , Hh          , Mm          , Mm          , Hh          , Hh          , Gs          , Hh          , Mm          , Hh          , Mm          , Hh          , Hh          , Gs          , Gs          , Gs          , Gs          , Hh          , Hh          , Gg          , Hh          , Hh          , Mm          , Hh          , Ds          , Gs          , Gs          , Ww          , Gs          , Gs          
Hh          , Gg^Ve       , Hh          , Gs          , Hh          , Hh          , Hh          , Hh          , Mm          , Mm          , Mm          , Mm          , Mm          , Mm          , Mm          , Mm          , Hh          , Gs          , Hh          , Hh          , Mm          , Mm          , Mm          , Mm          , Mm          , Gs          , Gs          , Gs          , Gs          , Hh          , Mm          , Gg          , Hh          , Mm          , Mm          , Hh          , Gs          , Gs          , Gs          , Ww          , Gs          , Gs          
Gs          , Gs          , Gs          , Gs          , Hh          , Hh          , Hh          , Hh          , Mm          , Mm          , Mm          , Hh          , Hh          , Mm          , Hh          , Hh          , Hh          , Gs          , Gs          , Hh          , Mm          , Mm          , Mm          , Mm          , Mm          , Hh          , Gs          , Gs          , Hh          , Hh          , Mm          , Mm          , Mm          , Mm          , Hh          , Hh          , Hh          , Hh          , Hh          , Ww          , Gs^Fp       , Gs          
Gs          , Gs          , Gs          , Gs          , Gs          , Hh          , Hh          , Hh          , Mm          , Mm          , Mm          , Hh          , Hh          , Hh          , Hh          , Hh          , Gs          , Gs          , Gs          , Hh          , Hh          , Mm          , Mm          , Mm          , Hh          , Hh          , Hh          , Hh          , Mm          , Mm          , Mm          , Mm          , Hh          , Hh          , Hh          , Gs          , Hh          , Hh          , Hh          , Ww          , Ww          , Gs          
Gs          , Gs          , Gs          , Ch          , Ch          , Ch          , Hh          , Mm          , Mm          , Mm          , Hh          , Mm          , Gs          , Gs          , Gs          , Gs          , Gs          , Gs          , Gs          , Gs          , Hh          , Hh          , Gs          , Hh          , Hh          , Gs          , Hh          , Hh          , Mm          , Mm          , Mm          , Mm          , Hh          , Gs          , Gs          , Gs          , Gs          , Hh          , Hh          , Hh          , Ww          , Gs^Fp       
Gs          , Gs          , Gs          , Ch          , 1 Kh        , Ch          , Hh          , Hh          , Hh          , Hh          , Hh          , Hh          , Gs          , Gs          , Gs          , Gs          , Gs          , Gs          , Hh          , Hh          , Hh          , Ss          , Hh          , Hh          , Hh          , Hh          , Gs          , Gs          , Hh          , Mm          , Hh          , Hh          , Hh          , Gs          , Gs          , Gs          , Gs          , Gs          , Hh          , Gg^Ve       , Ww          , Gs^Fp       
Gs          , Gs          , Gs          , Gs^Fp       , Ch          , Hh          , Re          , Gs          , Gs          , Gs          , Gs          , Gs          , Gs          , Gs          , Gs          , Gs          , Gs          , Gs          , Hh          , Hh          , Gs          , Gs          , Ss          , Gs          , Hh          , Hh          , Gs          , Gs          , Gs          , Gs          , Gs          , Gs          , Gs          , Gs          , Gs          , Gs          , Gs          , Gs          , Ww          , Ww          , Re          , Re          
Hh          , Gs          , Hh          , Hh          , Hh          , Re          , Gs^Fp       , Re          , Re          , Re          , Re          , Gg^Vh       , Re          , Re          , Re          , Gs          , Gs          , Gs          , Hh          , Gs          , Gs          , Gs          , Gs          , Gs          , Hh          , Hh          , Hh          , Gs          , Gs          , Gs          , Gs          , Gs          , Gs          , Gs          , Gs          , Gs          , Gs          , Ww          , Ww          , Re          , Gs^Fp       , Hh          
Hh          , Hh          , Hh          , Gs          , Gs          , Gs          , Gs          , Gs          , Gs          , Gs          , Gs          , Re          , Gs          , Gs          , Gs          , Re          , Re          , Hh          , Hh          , Gs          , Gs          , Gs          , Ss          , Gs          , Gs          , Hh          , Mm          , Mm          , Mm          , Gs          , Gs          , Gs          , Gs          , Gs          , Gs          , Gs          , Ww          , Ww          , Gs          , Re          , Hh          , Mm          
Gs          , Gs          , Hh          , Hh          , Gs          , Gs          , Gs          , Hh          , Gs          , Hh          , Gs          , Gs          , Gs          , Hh          , Hh          , Hh          , Hh          , Re          , Re          , Gs          , Gs          , Gs          , Ss          , Hh          , Hh          , Mm          , Mm          , Mm          , Mm          , Mm          , Gs          , Gs          , Gs          , Gs          , Gs          , Gs          , Ww          , Gs          , Re          , Re          , Hh          , Mm          
Gs          , Gs          , Gs          , Hh          , Hh          , Gs          , Hh          , Hh          , Hh          , Hh          , Mm          , Hh          , Mm          , Hh          , Mm          , Mm          , Ss          , Hh          , Hh          , Re          , Re          , Hh          , Hh          , Hh          , Gs          , Mm          , Mm          , Mm          , Gs          , Hh          , Hh          , Gs          , Gs          , Gs          , Gs          , Gs          , Ww          , Gs          , Re          , Ww          , Hh          , Mm          
Gs          , Gs          , Gs          , Hh          , Hh          , Gs          , Hh          , Hh          , Mm          , Mm          , Mm          , Hh          , Mm          , Mm          , Mm          , Mm          , Ss          , Hh          , Hh          , Hh          , Hh          , Re          , Re          , Gs          , Re          , Gs          , Gs          , Hh          , Gs          , Gs          , Hh          , Gs          , Gs          , Gs          , Gs          , Gs          , Ww^Bw/      , Re          , Ww          , Ww          , Ww          , Mm          
Gs          , Gs^Fp       , Gs^Fp       , Gs          , Gs          , Hh          , Mm          , Mm          , Mm          , Mm          , Mm          , Mm          , Mm          , Mm          , Mm          , Mm          , Ss          , Hh          , Gs          , Gs          , Gs          , Gg^Vh       , Gs          , Re          , Gs          , Re          , Re          , Hh          , Hh          , Hh          , Hh          , Gs          , Gs          , Gs          , Re          , Re          , Ww          , Ww          , Ww          , Ww          , Ww          , Hh          
Gs^Fp       , Gg^Ve       , Gs          , Gs          , Hh          , Hh          , Mm          , Mm          , Mm          , Mm          , Hh          , Mm          , Mm          , Mm          , Mm          , Mm          , Hh          , Hh          , Hh          , Gs          , Gs          , Gs          , Gs          , Gs          , Gs          , Gs          , Re          , Gg          , Hh          , Hh          , Hh          , Gs          , Gs          , Gs          , Re          , Hh          , Hh          , Ww          , Ww          , Ww          , Ww          , Mm          
Gs          , Gs          , Gs          , Gs          , Hh          , Mm          , Mm          , Mm          , Hh          , Gs          , Gs          , Hh          , Hh          , Hh          , Hh          , Hh          , Hh          , Hh          , Gs          , Gs          , Hh          , Gs          , Hh          , Gs          , Gs          , Gs          , Gs          , Re          , Re          , Gs          , Gs          , Gs          , Gs          , Gs          , Re          , Hh          , Mm          , Ww          , Ww          , Ww          , Ww          , Hh          
Gs          , Gs          , Gs          , Hh          , Mm          , Mm          , Mm          , Hh          , Gs          , Gs          , Gs          , Gs          , Gs          , Hh          , Gs          , Gs          , Gs          , Gs          , Gs          , Hh          , Mm          , Mm          , Hh          , Hh          , Gs          , Gs          , Gs          , Gs          , Gs          , Re          , Re          , Gs          , Gg^Vh       , Re          , Gs          , Ha          , Mm          , Mm          , Ww          , Ww          , Ww          , Hh          
Gs          , Hh          , Hh          , Hh          , Mm          , Mm          , Mm          , Hh          , Gg^Vh       , Hh          , Gs          , Gs          , Gs          , Gs          , Gs          , Gs          , Gs          , Gs          , Gs          , Hh          , Mm          , Mm          , Mm          , Hh          , Hh          , Gs          , Gs          , Gs          , Gs          , Gs          , Gs          , Re          , Re          , Re          , Gs          , Gs          , Mm          , Mm          , Mm          , Mm          , Mm          , Hh          
Hh          , Hh          , Hh          , Mm          , Mm          , Hh          , Mm          , Hh          , Gs          , Hh          , Gs          , Gs          , Gs          , Gs          , Gs          , Gs          , Gs          , Hh          , Mm          , Mm          , Mm          , Mm          , Hh          , Hh          , Hh          , Hh          , Hh          , Hh          , Hh          , Gs          , Gs          , Gs          , Re          , Gs          , Gs          , Gs          , Hh          , Mm          , Mm          , Mm          , Mm          , Mm          
Gs          , Gs          , Gs          , Hh          , Hh          , Mm          , Hh          , Hh          , Hh          , Hh          , Gs          , Gs          , Gs          , Gs          , Hh          , Mm          , Mm          , Mm          , Mm          , Mm          , Mm          , Mm          , Mm          , Mm          , Hh          , Mm          , Mm          , Hh          , Hh          , Hh          , Gs          , Gs          , Re          , Gs          , Gs          , Gs          , Hh          , Hh          , Hh          , Mm          , Mm          , Hh          
Gs          , Gs          , Gs          , Gs          , Gs          , Hh          , Hh          , Gs          , Gs          , Gs          , Gs          , Gs          , Gs          , Gs          , Hh          , Mm          , Mm          , Mm          , Mm          , Mm          , Mm          , Mm          , Mm          , Mm          , Mm          , Mm          , Mm          , Mm          , Hh          , Hh          , Gs          , Gs          , Re          , Gs          , Gs          , Gs          , Gs          , Gs          , Hh          , Hh          , Hh          , Hh          
Gs          , Gs          , Gs          , Gs          , Gs          , Gs          , Gs          , Gs          , Gs          , Gs          , Gs          , Gs^Fp       , Gs          , Hh          , Mm          , Mm          , Mm          , Mm          , Mm          , Mm          , Mm          , Mm          , Mm          , Mm          , Mm          , Mm          , Mm          , Hh          , Hh          , Gs          , Gs          , Gs          , Re          , Gs          , Gs          , Gs          , Gs          , Gs          , Gs          , Gs          , Gs          , Gs          
Gs          , Gs          , Gs          , Gs          , Gs          , Gs          , Gs          , Gs          , Gs          , Gs          , Gs          , Gs          , Gs          , Hh          , Mm          , Mm          , Mm          , Mm          , Mm^Vhh      , Mm          , Mm          , Mm          , Mm          , Mm          , Mm          , Mm          , Mm          , Hh          , Gs          , Gs          , Gs          , Gs          , Re          , Gs^Fp       , Gs^Fp       , Gs          , Gs          , Gs          , Gs          , Gs          , Gs          , Hh          
Gs          , Gs          , Gs          , Gs          , Gs          , Gs          , Gs          , Gs          , Gs          , Gs          , Gs          , Gs          , Gs^Fp       , Hh          , Mm          , Mm          , Mm          , Mm          , Mm          , Mm          , Mm          , Mm          , Mm          , Mm          , Mm          , Mm          , Hh          , Gs          , Gs          , Gs          , Gs          , Gs          , Re          , Gg^Ve       , Gs^Fp       , Gs          , Gs          , Gs          , Gs          , Gs          , Gs          , Hh          
Gs          , Gs          , Gs          , Gs          , Gs          , Gs          , Gs          , Gs          , Gs          , Gs          , Gs          , Hh          , Hh          , Mm          , Mm          , Mm          , Mm          , Mm          , Mm          , Mm          , Mm          , Mm          , Mm          , Mm          , Mm          , Mm          , Hh          , Gs          , Gs          , Gs          , Gs          , Gs          , Re          , Gs^Fp       , Gs          , Gs          , Gs          , Gs          , Gs          , Hh          , Hh          , Mm          
Gs          , Gs          , Gs          , Gs          , Gs          , Gs          , Gs          , Gs          , Gs          , Gs          , Mm          , Mm          , Mm          , Mm          , Mm          , Mm          , Mm          , Mm          , Mm          , Mm          , Mm          , Mm          , Mm          , Mm          , Mm          , Hh          , Hh          , Gs          , Gs          , Ds          , Ds          , Gs          , Re          , Gs          , Gs          , Gs          , Gs          , Gs          , Gs          , Gs          , Hh          , Mm          
Gs          , Gs          , Gs          , Gs          , Gs          , Gs^Fp       , Gs          , Gs^Fp       , Gs          , Hh          , Mm          , Mm          , Mm          , Mm          , Mm          , Mm          , Mm          , Mm          , Mm          , Mm          , Mm          , Mm          , Mm          , Mm          , Hh          , Hh          , Gs          , Gs          , Gs          , Gs          , Gs          , Gs          , Re          , Gs          , Gs          , Gs          , Gs          , Gs          , Gs          , Gs          , Hh          , Mm          
Gs          , Gs          , Gs          , Gs          , Gs          , Gs          , Gs^Fp       , Gs^Fp       , Hh          , Mm          , Mm          , Mm          , Mm          , Mm          , Mm          , Mm          , Mm          , Mm          , Mm          , Mm          , Mm          , Mm          , Mm          , Hh          , Gs          , Gs          , Gs          , Gs          , Gs          , Gs          , Hh          , Hh          , Re          , Gs          , Gs          , Gs          , Gs          , Gs          , Gg^Vh       , Gs          , Hh          , Mm          
Gs          , Gs          , Gs          , Gs          , Gs          , Gs          , Gs          , Gs          , Hh          , Mm          , Mm          , Mm          , Hh          , Mm          , Hh          , Hh          , Hh          , Hh          , Hh          , Hh          , Hh          , Hh          , Gs          , Gs          , Gs          , Gs          , Gs          , Gs          , Gs          , Hh          , Hh          , Hh          , Hh          , Re          , Gs          , Gs          , Gs          , Gs          , Gs          , Hh          , Hh          , Mm          
Gs          , Gs          , Gs          , Gs          , Gs          , Gs          , Gs          , Hh          , Hh          , Mm          , Hh          , Hh          , Hh          , Hh          , Hh          , Gg          , Hh          , Hh          , Hh          , Gs          , Gs          , Gs          , Gs          , Hh          , Mm          , Hh          , Hh          , Gs          , Gs          , Hh          , Hh          , Hh          , Re          , Re          , Gs          , Gs          , Gs^Fp       , Gs          , Gs          , Hh          , Hh          , Hh          
Gs          , Gs          , Gs          , Gs          , Gs          , Gs          , Gs          , Gs          , Hh          , Mm          , Hh          , Hh          , Gg^Vh       , Gs          , Gs          , Hh          , Mm          , Hh          , Gs          , Gs          , Gs          , Gs          , Gs          , Hh          , Mm          , Mm          , Mm          , Hh          , Gs          , Gs          , Gs          , Gs          , Re          , Gs          , Ds          , Ds          , Gs          , Gs          , Gs          , Gs          , Hh          , Gs          
Gs          , Gs          , Hh          , Hh          , Gs          , Gs          , Gs          , Gs          , Gs          , Hh          , Hh          , Gs          , Gs          , Gs          , Gs          , Hh          , Mm          , Hh          , Gs          , Gs          , Gs          , Gs          , Gs          , Hh          , Mm          , Mm          , Mm          , Hh          , Hh          , Gs          , Gs          , Gs          , Re          , Ww          , Ww          , Ds          , Gs          , Gs          , Gs          , Gs          , Gs          , Gs          
Gs          , Hh          , Gg^Ve       , Hh          , Hh          , Hh          , Hh          , Hh          , Hh          , Gs          , Gs          , Gs          , Gs          , Gs          , Gs          , Hh          , Mm          , Mm          , Mm          , Gs          , Gs          , Gs          , Gs          , Hh          , Mm          , Mm          , Mm          , Mm          , Hh          , Gs          , Gs          , Gg^Vh       , Ch          , Ch          , Ch          , Gs          , Gs          , Gs          , Gs          , Gs          , Gs^Fp       , Gs          
Gs          , Hh          , Hh          , Gs          , Hh          , Hh          , Hh          , Hh          , Gs          , Gs          , Gs          , Gs          , Gs          , Gs          , Gs^Fp       , Gs          , Hh          , Mm          , Mm          , Hh          , Gs          , Gs          , Gs          , Hh          , Mm          , Mm          , Mm          , Mm          , Hh          , Gs          , Gs          , Re          , Ch          , 2 Kh        , Ch          , Gs          , Gs          , Gs          , Gs          , Gs^Fp       , Gs^Fp       , Gs^Fp       
Gs          , Gs          , Hh          , Gs          , Gs          , Gs          , Hh          , Hh          , Hh          , Gs          , Gs          , Gs          , Gs          , Gs^Fp       , Gs          , Gs          , Hh          , Mm          , Hh          , Hh          , Gs          , Gs          , Gs          , Hh          , Hh          , Mm          , Mm          , Mm          , Gs          , Gs          , Gs          , Gs          , Gs          , Ch          , Gs          , Gs          , Gs          , Gs          , Gs          , Gs          , Gs          , Gs^Fp       
Gs          , Gs          , Hh          , Gs          , Gs          , Gs          , Hh          , Hh          , Hh          , Hh          , Gs          , Gs          , Gs^Fp       , Gs^Fp       , Gs          , Gs          , Gs          , Gs          , Gs          , Hh          , Gs          , Gs          , Gs          , Gs^Fp       , Gs^Fp       , Hh          , Hh          , Gs          , Re          , Re          , Gs          , Gs          , Gs          , Gs          , Gs          , Gs          , Gs          , Gs          , Gs          , Gs          , Gs          , Gs^Fp       
Gs          , Gs          , Hh          , Hh          , Hh          , Hh          , Hh          , Hh          , Hh          , Hh          , Gg^Vh       , Gs          , Gs          , Gs          , Gs          , Gs          , Gs          , Gs          , Gs          , Gs          , Gs          , Gs          , Gs          , Gs          , Gs          , Gs          , Gs          , Re          , Gs          , Gs          , Gs          , Gs          , Gs          , Gs          , Gs          , Gs          , Gs          , Gs          , Gs          , Gs          , Gs          , Gs^Fp       
Gs          , Gs          , Hh          , Hh          , Hh          , Mm          , Hh          , Mm          , Mm          , Hh          , Gs          , Gs          , Gs          , Gs          , Gs          , Gs          , Gs          , Gs          , Gs          , Gs          , Gs          , Gs          , Gg^Vh       , Gs          , Gs          , Gs          , Gs          , Re          , Gs          , Gs          , Gs          , Gs          , Gs          , Gs          , Gs          , Gs          , Gs          , Gs          , Gs          , Gs          , Gs          , Gs          
Gs          , Gs          , Hh          , Hh          , Mm          , Mm          , Mm          , Mm          , Mm          , Hh          , Gs          , Gs          , Gs          , Gs          , Gs          , Gs          , Gs          , Gs          , Gs          , Gs          , Gs          , Gs          , Re          , Gs          , Re          , Re          , Re          , Re          , Gs          , Gs          , Gs          , Gs          , Gs          , Gs          , Gs          , Gs          , Gs          , Gs          , Gs          , Gs          , Gs          , Gs          
