border_size=1
usage=map

Gs          , Gs          , Mm          , Mm          , Mm          , Gs          , Hh          , Gs          , Gs          , Gs          , Gs          , Gs          , Gs          , Gs          , Gs          , Gs          , Mm          , Mm          , Mm          , Gs          , Gs          
Gs          , Mm          , Mm          , Mm          , Mm          , Mm          , Hh          , Hh          , Gs          , Gs          , Ce          , Gs          , Gs          , Gs          , Gs          , Mm          , Mm          , Mm          , Mm          , Mm^Vhh      , Mm          
Mm          , Mm          , Mm          , Mm          , Mm          , Mm          , Ce          , Ce          , 1 Ke        , Ce          , Ce          , Ce          , Gs          , Gs          , Gs          , Mm          , Mm          , Mm          , Mm          , Mm          , Mm          
Mm          , Mm          , Mm          , Mm          , Mm          , Mm          , Hh          , Ce          , Gs          , Ce          , Gs          , Gs          , Gs          , Gs          , Gs          , Mm          , Mm          , Mm          , Cud         , Mm          , Mm          
Mm          , Mm          , Mm          , Mm          , Mm          , Hh          , Gs          , Gs          , Gs          , Rd          , Gs          , Gs          , Gs          , Gs          , Mm          , Mm          , Mm          , Mm          , Cud         , 2 Kud       , Mm          
Mm          , Mm          , Mm          , Mm          , Hh          , Gs^Fp       , Gs^Fp       , Gs          , Rd          , Rd          , Gs          , Gs          , Gs          , Mm          , Mm          , Mm          , Mm          , Mm          , Mm          , Mm          , Mm          
Mm          , Mm          , Mm          , Mm          , Hh          , Gs^Fp       , Gs          , Gs          , Rd          , Gs          , Gs          , Gs          , Gs          , Mm          , Mm          , Mm          , Mm          , Mm          , Mm          , Mm          , Mm          
Mm          , Mm          , Gs^Fp       , Hh          , Gs^Fp       , Gs^Fp       , Gs          , Gs          , Rd          , Gs^Vht      , Mm          , Mm          , Mm          , Mm          , Mm          , Mm          , Mm          , Mm          , Mm          , Mm          , Mm          
Mm          , Mm          , Mm^Vhh      , Gs^Fp       , Hh          , Hh          , Gs          , Rd          , Gs          , Mm          , Mm          , Mm          , Mm          , Mm          , Mm          , Mm          , Mm          , Mm          , Mm          , Mm          , Mm          
Mm          , Mm          , Mm          , Hh          , Hh          , Hh          , Gs          , Rd          , Gs          , Mm          , Mm          , Mm          , Mm          , Mm          , Mm          , Mm          , Mm          , Mm          , Mm          , Mm          , Mm          
Mm          , Mm          , Mm          , Hh          , Hh          , Gs          , Rd          , Rd          , Mm          , Mm          , Mm          , Mm          , Mm          , Mm          , Gs^Fp       , Mm          , Gs^Fp       , Mm          , Mm          , Mm          , Mm          
Mm          , Mm          , Mm          , Mm          , Hh          , Gs          , Rd          , Rd          , Mm          , Mm          , Mm          , Mm          , Mm          , Gs^Fp       , Gs^Fp       , Gs^Fp       , Gs^Fp       , Mm          , Mm          , Mm          , Mm          
Mm          , Mm          , Mm          , Hh          , Hh          , Hh          , Gs          , Gs          , Mm          , Mm          , Mm          , Mm          , Mm          , Mm          , Gs^Fp       , Gs^Fp       , Mm          , Mm          , Mm          , Mm          , Mm          
Mm          , Mm          , Mm          , Hh          , Hh          , Hh          , Hh          , Rd          , Mm          , Mm          , Mm          , Mm          , Mm          , Mm          , Mm          , Gs^Fp       , Mm          , Mm          , Mm          , Mm          , Mm          
Mm          , Mm          , Mm          , Mm          , Mm          , Hh          , Hh          , Hh          , Mm          , Mm          , Mm          , Mm          , Mm          , Mm          , Mm          , Mm          , Mm          , Mm          , Mm          , Mm          , Mm          
Mm          , Mm          , Mm          , Mm          , Mm          , Hh          , Hh          , Hh          , Mm          , Mm          , Mm          , Mm          , Mm          , Mm          , Mm          , Mm          , Mm          , Mm          , Mm          , Mm          , Mm          
Mm          , Mm          , Mm          , Mm          , Gs^Fp       , Gs^Fp       , Hh          , Hh          , Hh          , Mm          , Mm          , Mm          , Mm          , Mm          , Mm          , Mm          , Mm          , Mm          , Mm          , Mm          , Mm          
Mm          , Mm          , Mm          , Mm          , Gs^Fp       , Gs^Fp       , Hh          , Hh          , Gs^Vht      , Hh          , Hh          , Mm          , Mm          , Mm          , Mm          , Mm          , Mm          , Mm          , Mm          , Mm          , Mm          
Mm          , Mm          , Cud         , Mm          , Gs^Fp       , Gs^Fp       , Hh          , Rd          , Rd          , Hh          , Hh          , Mm          , Mm          , Mm          , Mm          , Mm          , Mm          , Mm          , Mm          , Mm          , Mm          
Mm          , 3 Kud       , Cud         , Mm          , Hh          , Hh          , Hh          , Gs          , Rd          , Gs          , Hh          , Mm          , Mm          , Mm          , Gs^Fp       , Mm          , Mm          , Mm          , Mm          , Mm          , Mm          
Mm          , Mm          , Mm          , Mm          , Hh          , Hh          , Gs          , Gs          , Rd          , Hh          , Hh          , Mm          , Mm          , Gs^Fp       , Gs^Fp       , Mm          , Mm          , Mm          , Mm^Vhh      , Mm          , Mm          
Mm          , Mm          , Mm          , Mm          , Mm          , Hh          , Hh          , Gs          , Rd          , Hh          , Hh          , Mm          , Gs^Fp       , Mm          , Mm          , Mm          , Mm          , Mm          , Mm          , Mm          , Mm          
Mm          , Mm          , Mm          , Mm          , Mm          , Mm          , Hh          , Gs          , Rd          , Gs          , Hh          , Gs^Fp       , Hh          , Mm          , Gs^Fp       , Mm          , Mm          , Mm          , Mm          , Mm          , Mm          
Mm          , Mm          , Mm          , Mm          , Mm          , Mm          , Mm          , Hh          , Rd          , Gs          , Gs          , Gs^Fp       , Hh          , Mm          , Mm          , Mm          , Mm          , Mm          , Mm          , Mm          , Mm          
Gs          , Mm          , Mm          , Mm          , Mm          , Mm          , Mm          , Mm          , Rd          , Hh          , Gs          , Gs          , Gs^Fp       , Gs^Fp       , Mm          , Mm          , Mm          , Mm          , Mm          , Mm          , Gs          
Mm          , Mm          , Mm          , Mm          , Mm          , Mm          , Mm          , Mm          , Hh          , Rd          , Gs          , Gs^Fp       , Hh          , Hh          , Mm          , Mm          , Mm          , Mm          , Mm          , Mm          , Mm          
Mm          , Mm          , Mm          , Mm          , Mm          , Mm          , Mm          , Mm          , Hh          , Rd          , Gs          , Gs          , Hh          , Mm          , Mm          , Mm          , Mm          , Mm          , Mm          , Mm          , Mm          
Mm          , Mm          , Mm          , Mm          , Gs^Fp       , Gs^Fp       , Gs^Fp       , Hh          , Hh          , Rd          , Gs          , Gs          , Hh          , Mm          , Mm          , Mm          , Mm          , Mm          , Mm          , Mm          , Mm          
Mm          , Mm          , Mm          , Mm          , Mm          , Mm          , Mm          , Gs^Fp       , Hh          , Rd          , Rd          , Gs^Vht      , Hh          , Mm          , Mm          , Mm          , Mm          , Mm          , Mm          , Mm          , Mm          
Mm          , Mm          , Mm          , Mm          , Mm          , Mm          , Mm          , Gs^Fp       , Hh          , Hh          , Gs          , Rd          , Hh          , Mm          , Mm          , Mm          , Mm          , Mm          , Mm          , Mm          , Mm          
Mm          , Mm          , Mm          , Mm          , Mm          , Mm^Vhh      , Mm          , Gs^Fp       , Hh          , Gs          , Gs          , Rd          , Hh          , Mm          , Mm          , Mm          , Mm          , Mm          , Mm          , Mm          , Mm          
Mm          , Mm          , Mm          , Mm          , Mm          , Mm          , Mm          , Mm          , Hh          , Gs          , Gs          , Gs          , Hh          , Mm          , Mm          , Mm          , Mm          , Mm          , Mm          , Hh          , Mm          
Mm          , Mm          , Mm          , Mm          , Mm          , Mm          , Mm          , Hh          , Gs          , Gs          , Rd          , Gs          , Gs^Fp       , Mm          , Gs^Fp       , Mm          , Mm          , Mm          , Cud         , Hh          , Gs          
Mm          , Mm          , Mm          , Mm          , Mm          , Mm          , Mm          , Hh          , Gs          , Gs          , Rd          , Gs          , Gs^Fp       , Mm          , Mm          , Gs^Fp       , Mm          , Cud         , 4 Kud       , Hh          , Gs          
Mm          , Mm          , Mm          , Mm          , Mm          , Mm          , Hh          , Hh          , Gs          , Gs          , Rd          , Gs^Fp       , Hh          , Mm          , Mm          , Gs^Fp       , Mm          , Mm          , Mm          , Hh          , Gs          
Mm          , Mm          , Mm          , Mm          , Mm          , Mm          , Hh          , Gs          , Gs          , Rd          , Rd          , Gs          , Hh          , Mm          , Gs^Fp       , Gs^Fp       , Mm          , Mm          , Mm          , Hh          , Gs          
Mm          , Mm          , Mm          , Mm          , Mm          , Hh          , Hh          , Gs          , Gs          , Rd          , Rd          , Gs          , Gs          , Gs^Fp       , Mm          , Mm          , Mm          , Mm          , Mm          , Hh          , Gs          
Mm          , Mm          , Mm          , Mm          , Mm          , Mm          , Hh          , Hh          , Gs^Vht      , Rd          , Gs          , Gs          , Gs          , Hh          , Mm          , Mm          , Mm          , Mm          , Mm          , Hh          , Gs          
Mm          , Mm          , Mm          , Mm          , Mm          , Mm          , Mm          , Hh          , Gs          , Gs          , Gs          , Gs          , Gs          , Hh          , Mm          , Mm          , Mm          , Mm          , Mm          , Hh          , Gs          
Mm          , Mm          , Mm          , Mm          , Mm          , Mm          , Mm          , Gs^Fp       , Hh          , Gs          , Gs          , Gs          , Gs          , Hh          , Mm          , Mm          , Mm          , Mm          , Mm          , Hh          , Gs          
Mm          , Mm          , Mm          , Mm          , Mm          , Mm          , Mm          , Mm          , Gs^Fp       , Hh          , Hh          , Rd          , Gs          , Hh          , Mm          , Mm          , Mm          , Mm          , Mm          , Hh          , Gs          
Mm          , Mm          , Mm          , Mm          , Mm          , Mm          , Mm          , Mm          , Gs^Fp       , Mm          , Hh          , Rd          , Gs          , Hh          , Mm          , Mm          , Mm          , Mm          , Mm          , Hh          , Gs          
Mm          , Mm          , Mm          , Mm          , Mm          , Mm          , Mm          , Mm          , Mm          , Mm          , Hh          , Rd          , Rd          , Hh          , Hh          , Mm          , Mm          , Mm          , Mm          , Mm          , Mm          
Mm          , Mm          , Mm          , Mm          , Mm          , Mm          , Mm          , Mm          , Mm          , Gs^Fp       , Hh          , Rd          , Gs          , Hh          , Hh          , Hh          , Mm          , Mm          , Mm          , Mm          , Mm          
Mm          , Mm          , Mm          , Mm          , Mm          , Mm          , Mm          , Mm          , Gs^Fp       , Gs^Fp       , Gs          , Gs          , Gs          , Gs          , Gs          , Hh          , Mm          , Mm          , Mm          , Mm          , Mm          
Mm          , Mm          , Mm          , Mm          , Mm          , Mm          , Mm          , Mm          , Hh          , Gs          , Gs          , Gs          , Rd          , Gs          , Gs^Fp       , Hh          , Hh          , Mm          , Mm          , Mm          , Mm          
Mm          , Mm          , Mm          , Mm          , Mm          , Mm          , Mm          , Hh          , Hh          , Gs          , Gs          , Rd          , Rd          , Gs^Fp       , Hh          , Hh          , Mm          , Mm          , Mm          , Mm          , Mm          
Mm          , Mm          , Mm          , Mm          , Mm          , Mm          , Mm          , Mm          , Mm          , Gs^Fp       , Gs^Fp       , Rd          , Gs^Vht      , Hh          , Mm          , Mm          , Mm          , Mm          , Mm          , Mm          , Mm          
Mm          , Mm          , Mm          , Mm          , Mm          , Mm          , Mm          , Mm          , Gs^Fp       , Gs^Fp       , Gs^Fp       , Rd          , Rd          , Hh          , Mm          , Mm          , Mm          , Mm          , Mm          , Mm          , Mm          
Mm          , Mm          , Mm          , Mm          , Mm          , Cud         , Cud         , Mm          , Gs^Fp       , Gs^Fp       , Gs^Fp       , Rd          , Rd          , Hh          , Gs^Fp       , Mm          , Mm          , Mm          , Mm          , Mm          , Mm          
Mm          , Mm          , Mm          , Mm          , Mm          , 5 Kud       , Mm          , Mm          , Mm          , Gs^Fp       , Gs^Fp       , Hh          , Gs          , Hh          , Gs^Fp       , Mm          , Mm          , Mm          , Mm          , Mm          , Mm          
Gs          , Mm          , Mm          , Mm          , Mm          , Mm          , Mm          , Mm          , Gs          , Gs^Fp       , Gs          , Gs          , Gs          , Gs^Fp       , Mm          , Mm          , Mm          , Mm          , Mm          , Mm          , Mm          
