border_size=1
usage=map

Hh          , Hh          , Hh          , Gs          , Mm          , Mm          , Mm          , Mm          , Mm          , Mm          , Mm^Xm       , Mm^Xm       , Mm^Xm       , Mm^Xm       , Mm^Xm       , Mm^Xm       , Mm^Xm       , Mm^Xm       , Mm          , Mm          , Mm          , Gs          , Hh          , Hh          , Hh          , Hh          , Hh          , Hh          , Hh          , Hh          , Gs          , Gs          , Gs          
Hh          , Hh          , Hh          , Hh          , Mm          , Mm          , Mm          , Mm          , Mm          , Mm          , Mm^Xm       , Mm^Xm       , Mm^Xm       , Mm^Xm       , Mm^Xm       , Mm^Xm       , Mm^Xm       , Mm^Xm       , Mm          , Mm          , Mm          , Mm          , Mm^Vhh      , Hh          , Hh          , Hh          , Hh          , Hh          , Hh          , Hh          , Hh          , Gs          , Gs          
Gs          , Hh          , Hh          , Hh          , Hh          , Mm          , Hh          , Mm          , Mm          , Mm          , Mm          , Mm^Xm       , Mm^Xm       , Mm^Xm       , Mm^Xm       , Mm^Xm       , Mm^Xm       , Mm          , Mm          , Mm          , Mm          , Mm          , Mm          , Mm          , Hh          , Hh          , Hh          , Hh          , Hh          , Hh          , Hh          , Hh          , Gs          
Hh          , Hh          , Hh          , Hh          , Hh          , Hh          , Hh          , Hh          , Mm          , Mm          , Mm          , Mm          , Mm          , Mm          , Mm          , Mm^Xm       , Mm          , Mm          , Mm          , Mm          , Mm          , Mm          , Mm          , Mm          , Hh          , Hh          , Hh          , Hh          , Hh          , Hh          , Hh          , Hh          , Hh          
Hh          , Hh          , Hh          , Hh          , Hh          , Hh          , Hh          , Hh          , Hh          , Mm          , Mm          , Mm          , Mm          , Mm          , Mm          , Mm          , Mm          , Mm          , Mm          , Mm          , Mm          , Mm          , Hh          , Hh          , Hh          , Hh          , Hh          , Hh          , Gs          , Hh          , Hh          , Hh          , Hh          
Hh          , Hh          , Hh          , Hh          , Hh          , Hh          , Hh          , Hh          , Hh          , Hh          , Hh          , Hh          , Hh          , Mm          , Hh^Vhh      , Mm          , Mm          , Mm          , Hh          , Hh          , Hh          , Hh          , Hh          , Hh          , Hh          , Hh          , Hh          , Hh          , Hh          , Hh          , Hh          , Hh          , Hh          
Hh          , Hh          , Hh          , Hh          , Gs          , Hh          , Hh^Vhh      , Hh          , Hh          , Hh          , Hh          , Hh          , Hh          , Hh          , Hh          , Hh          , Hh          , Hh          , Hh          , Hh          , Hh          , Hh          , Hh          , Hh          , Hh          , Hh          , Hh          , Hh          , Hh          , Hh          , Hh          , Hh          , Hh          
Hh          , Hh          , Hh          , Hh          , Hh          , Hh          , Hh          , Hh          , Hh          , Hh          , Hh          , Hh          , Hh          , Hh          , Hh          , Hh          , Ce          , Hh          , Ce          , Hh          , Hh          , Hh          , Hh          , Hh          , Hh          , Hh          , Hh          , Hh          , Hh          , Hh          , Hh          , Hh          , Gs          
Gs          , Hh          , Hh          , Hh          , Hh          , Hh          , Hh          , Hh          , Hh          , Hh          , Gs^Fp       , Hh          , Hh          , Hh          , Gs          , Ce          , Gs          , Ce          , 1 Ke        , Ce          , Hh          , Hh          , Hh          , Hh          , Hh          , Hh          , Hh          , Hh          , Hh          , Hh          , Hh          , Hh          , Gs          
Gs          , Gs          , Hh          , Hh          , Hh          , Hh          , Hh          , Hh          , Gs^Fp       , Gs^Fp       , Hh          , Hh          , Hh          , Gs          , Gs          , Gs          , Gs          , Ce          , Hh          , Hh          , Hh          , Hh          , Hh          , Hh          , Hh          , Hh          , Hh          , Hh          , Hh          , Hh^Vhh      , Hh          , Hh          , Gs          
Gs          , Gs          , Hh          , Gs          , Hh          , Hh          , Hh          , Hh          , Gs^Fp       , Gs^Fp       , Hh          , Rd          , Rd          , Hh          , Hh          , Gs          , Gs          , Gs          , Gs          , Hh          , Hh          , Hh          , Hh          , Hh          , Hh          , Hh          , Hh          , Hh          , Hh          , Hh          , Hh          , Hh          , Gs          
Gs          , Hh          , Hh          , Hh          , Hh          , Hh          , Gs^Fp       , Gs^Fp       , Gs^Fp       , Hh          , Gs          , Hh          , Rd          , Hh          , Gs          , Hh          , Gs          , Gs          , Gs          , Hh          , Hh          , Hh          , Hh          , Hh          , Hh          , Hh          , Hh          , Hh          , Hh          , Hh          , Hh          , Hh          , Gs          
Gs          , Gs          , Gs          , Gs          , Gs          , Hh          , Hh          , Gs^Fp       , Gs^Fp       , Hh          , Gs          , Hh          , Rd          , Hh          , Gs          , Gs          , Gs          , Gs          , Hh          , Gs          , Hh          , Hh          , Hh          , Hh          , Hh          , Hh          , Hh          , Hh          , Hh          , Hh          , Hh          , Hh          , Hh          
Gs          , Gs          , Hh          , Gs          , Gs          , Gs          , Gs          , Gs^Fp       , Gs          , Gs          , Gs^Vht      , Gs          , Rd          , Gs          , Gs          , Gs          , Gs          , Hh          , Hh          , Hh          , Gs          , Hh          , Gs          , Hh          , Hh          , Hh          , Hh          , Hh          , Hh          , Hh          , Hh          , Hh          , Hh          
Gs          , Gs          , Gs          , Gs          , Gs          , Gs          , Hh          , Hh          , Hh          , Gs          , Gs          , Gs          , Rd          , Gs          , Gs          , Hh          , Gs          , Gs          , Gs          , Hh          , Hh          , Hh          , Hh          , Hh          , Gs          , Hh          , Gs          , Hh          , Hh          , Hh          , Hh          , Hh          , Gs          
Gs          , Gs          , Hh          , Hh          , Gs          , Hh          , Gs          , Hh          , Gs          , Hh          , Gs          , Gs          , Rd          , Gs          , Gs          , Hh          , Hh          , Gs          , Gs          , Hh          , Gs          , Hh          , Gs          , Hh          , Gs          , Hh          , Hh          , Gs          , Hh          , Hh          , Hh          , Hh          , Gs          
Gs          , Gs          , Hh          , Gs          , Gs          , Gs          , Hh          , Hh          , Gs          , Gs          , Hh          , Gs          , Rd          , Hh          , Gs          , Hh          , Hh          , Hh          , Gs          , Hh          , Hh          , Gs          , Gs          , Gs          , Hh          , Hh          , Hh          , Hh          , Hh          , Hh          , Hh          , Gs          , Gs          
Gs          , Hh          , Gs          , Gs          , Gs          , Hh          , Chr         , Gs          , Hh          , Hh          , Gs          , Gs          , Rd          , Gs          , Gs          , Gs          , Hh          , Hh          , Hh          , Gs          , Gs          , Gs          , Gs          , Gs          , Gs          , Gs          , Gs          , Hh          , Gs          , Gs          , Hh          , Hh          , Gs          
Gs          , Hh          , Hh          , Gs          , Gs          , Gs          , Gs          , Gs          , Hh          , Gs          , Gs^Fp       , Hh          , Rd          , Hh          , Hh          , Gs          , Hh          , Hh          , Gs^Fp       , Gs^Fp       , Gs          , Gs          , Hh          , Gs          , Gs          , Gs          , Gs          , Gs          , Gs          , Gs          , Gs          , Gs          , Gs          
Gs          , Gs          , Hh          , Gs          , Gs          , Gs          , Chr         , Gs          , Gs          , Chr         , Gs^Fp       , Hh          , Hh          , Rd          , Rd          , Hh          , Hh          , Gs^Fp       , Hh          , Hh          , Gs          , Hh          , Hh          , Gs          , Gs          , Hh          , Hh          , Gs          , Hh          , Hh          , Hh          , Gs          , Gs          
Gs          , Ww          , Ww          , Hh          , Gs          , Chr         , 4 Khr       , Chr         , Gs^Fp       , Gs^Fp       , Gs^Fp       , Gs^Vht      , Gs^Fp       , Hh          , Hh          , Rd          , Gs          , Hh          , Gs          , Gs          , Hh          , Hh          , Gs          , Hh          , Gs^Vht      , Gs          , Hh          , Hh          , Hh          , Gs          , Gs          , Hh          , Gs          
Gs          , Gs          , Gs          , Ww          , Ww          , Chr         , Chr         , Chr         , Gs^Fp       , Gs^Fp       , Gs^Fp       , Gs^Fp       , Gs^Fp       , Gs          , Gs          , Gs          , Gs          , Hh          , Gs          , Gs          , Gs          , Gs          , Gs          , Gs          , Gs          , Gs          , Gs          , Gs          , Gs          , Hh          , Gs          , Hh          , Gs          
Gs          , Gs          , Hh          , Gs          , Gs          , Ww          , Ww          , Ww          , Ww          , Chr         , Ww          , Hh          , Gs          , Gs          , Ww          , Ww^Bw|      , Ww          , Ww          , Ww          , Ww          , Ww          , Ww          , Ww          , Ww          , Ww          , Gs          , Ww          , Ww          , Ww          , Gs          , Hh          , Hh          , Gs          
Gs          , Gs          , Hh          , Gs          , Gs          , Gs          , Gs          , Gs          , Gs          , Ww          , Gs          , Ww          , Ww          , Ww          , Gs          , Gs          , Gs          , Gs          , Gs          , Gs          , Gs          , Gs          , Gs          , Gs          , Gs          , Ww          , Gs          , Gs          , Gs          , Ww          , Ww          , Gs          , Gs          
Gs          , Gs          , Hh          , Gs          , Hh          , Gs          , Hh          , Gs          , Gs          , Gs          , Gs          , Gs          , Gs          , Gs          , Gs^Fp       , Rd          , Hh          , Gs          , Hh          , Hh          , Hh          , Hh          , Gs          , Gs          , Gs          , Hh          , Gs          , Gs          , Hh          , Gs          , Gs          , Ww          , Gs          
Gs          , Hh          , Hh          , Hh          , Gs          , Gs          , Gs          , Gs          , Gs          , Hh          , Hh          , Hh          , Gs^Fp       , Gs^Fp       , Hh          , Rd          , Rd          , Hh          , Gs          , Hh          , Hh          , Hh          , Hh          , Gs          , Gs          , Gs          , Hh          , Hh          , Gs          , Hh          , Hh          , Gs          , Gs          
Gs          , Gs          , Hh          , Gs          , Hh          , Gs          , Gs          , Gs          , Gs          , Gs          , Gs          , Gs          , Gs^Fp       , Gs^Fp       , Hh          , Gs          , Rd          , Gs          , Hh          , Gs          , Gs^Fp       , Gs^Fp       , Gs^Fp       , Gs          , Gs          , Gs          , Gs          , Gs          , Gs          , Gs          , Gs          , Hh          , Gs          
Gs          , Gs          , Gs          , Hh          , Hh          , Gs          , Hh          , Gs          , Gs          , Hh          , Gs          , Gs          , Gs          , Gs          , Gs          , Gs          , Rd          , Gs          , Gs^Fp       , Gs^Fp       , Gs^Fp       , Gs^Fp       , Hh          , Hh          , Hh          , Hh          , Gs          , Gs          , Gs          , Gs          , Hh          , Hh          , Gs          
Gs          , Gs          , Gs          , Gs          , Gs          , Hh          , Hh          , Hh          , Gs          , Gs          , Hh          , Gs          , Hh          , Hh          , Hh          , Hh          , Hh          , Rd          , Hh          , Gs^Fp       , Hh          , Hh          , Hh          , Hh          , Gs          , Gs          , Gs          , Gs          , Hh          , Hh          , Hh          , Gs          , Gs          
Gs          , Gs^Vht      , Gs          , Gs          , Hh          , Gs          , Hh          , Hh          , Hh          , Hh          , Gs          , Hh          , Gs          , Hh          , Gs^Fp       , Hh          , Hh          , Rd          , Hh          , Hh          , Hh          , Hh          , Gs          , Hh          , Gs          , Hh          , Gs          , Hh          , Hh          , Gs          , Gs          , Hh          , Hh          
Gs          , Gs          , Hh          , Hh          , Hh          , Hh          , Hh          , Gs          , Gs          , Gs          , Gs          , Gs          , Gs^Vht      , Hh          , Gs^Fp       , Gs^Fp       , Gs^Fp       , Rd          , Gs          , Hh          , Chr         , Gs          , Gs          , Hh          , Gs          , Gg^Ve       , Hh          , Hh          , Hh          , Gs          , Gs          , Gs          , Gs          
Gs          , Hh          , Hh          , Hh          , Gs          , Hh          , Gs          , Hh          , Hh          , Gs          , Gs          , Gs          , Gs          , Hh          , Gs^Fp       , Rr          , Rr          , Rr          , Rr          , Chr         , 3 Khr       , Chr         , Gg          , Hh          , Hh          , Gs          , Hh          , Gs          , Hh          , Gs          , Gs          , Gs          , Hh          
Gs          , Gs          , Gs          , Gs          , Gs          , Gs          , Gs          , Gs          , Gg          , Gs          , Gs          , Gs          , Gs          , Hh          , Rr          , Rr          , Gg^Vh       , Rr          , Gg          , Chr         , Chr         , Chr         , Gg          , Gg          , Gg          , Hh          , Gg          , Hh          , Hh          , Gg          , Gs          , Hh          , Gs          
Gs          , Gs          , Gs          , Gs          , Gg          , Gg          , Hh          , Hh          , Gg          , Hh          , Hh          , Hh          , Hh          , Rr          , Hh          , Hh          , Hh          , Gs          , Hh          , Gg          , Gg          , Gg          , Gs          , Gs          , Hh          , Hh          , Gs          , Gg          , Gs          , Gs          , Gg          , Gg          , Gg          
Gs          , Gs          , Gs          , Gg          , Hh          , Hh          , Hh          , Hh          , Gg          , Gs          , Gg          , Hh          , Hh          , Hh          , Rr          , Hh          , Hh          , Hh          , Hh          , Gs          , Hh          , Gg          , Hh          , Hh          , Gg          , Gg          , Gs          , Gs          , Hh          , Gg          , Hh          , Gg          , Gg          
Gs          , Gs          , Gg          , Gg          , Hh          , Hh          , Hh          , Hh          , Gg          , Gg          , Hh          , Hh          , Rr          , Gg          , Gg          , Hh          , Gs^Fp       , Gs^Fp       , Hh          , Hh          , Hh          , Hh          , Hh          , Hh          , Gs          , Gs          , Hh          , Hh          , Gg          , Hh          , Hh          , Gg          , Gg          
Gg          , Gg          , Gg          , Hh          , Hh          , Gg          , Hh          , Hh          , Gs          , Hh          , Ch          , Ch          , Ch          , Gg          , Gg^Ve       , Hh          , Gs^Fp       , Gs^Fp       , Gg          , Gg          , Hh          , Hh          , Gs          , Gs          , Hh          , Gg          , Hh          , Gs          , Hh          , Gg          , Hh          , Gs          , Hh          
Gg          , Gg          , Hh          , Hh          , Hh          , Hh          , Hh          , Hh          , Gg          , Gs          , Ch          , 2 Kh        , Ch          , Gs          , Gg          , Gg          , Hh          , Hh          , Hh          , Gs          , Hh          , Gg^Vh       , Hh          , Gs          , Gs          , Gg          , Hh          , Hh          , Hh          , Hh          , Gg          , Gg          , Gs          
Gg          , Hh          , Hh          , Hh          , Hh          , Hh          , Hh          , Gg          , Gs          , Gs          , Gg          , Ch          , Gs          , Gg          , Hh          , Hh          , Gg          , Gg          , Gs          , Gg          , Gs          , Gs          , Hh          , Gs          , Gg          , Gs          , Hh          , Hh          , Gg          , Hh          , Gg          , Hh          , Gs          
Gg          , Gg          , Gg          , Hh          , Hh          , Hh          , Gg          , Hh          , Hh          , Hh          , Gg          , Hh          , Gg          , Gs          , Hh          , Hh          , Hh          , Hh          , Hh          , Hh          , Hh          , Gg          , Hh          , Hh          , Gg          , Hh          , Hh          , Hh          , Gs          , Gg          , Gg          , Gs          , Gs          
Gg          , Gg^Vh       , Gg          , Hh          , Hh          , Hh          , Hh          , Hh          , Hh          , Gs          , Hh          , Gg          , Hh          , Hh          , Gs          , Hh          , Hh          , Hh          , Hh          , Hh          , Gg          , Hh          , Gg          , Hh          , Gg          , Hh          , Hh          , Hh          , Gg          , Gs          , Hh          , Gg          , Gs          
Gg          , Gg          , Gg          , Gg          , Gg          , Hh          , Gg          , Hh          , Gg          , Gg          , Hh          , Hh          , Gs          , Gs          , Gs          , Gs          , Gg          , Gg          , Gg          , Gg          , Gg          , Gg          , Hh          , Gg          , Gg          , Gg          , Gg          , Gg          , Hh          , Hh          , Gg          , Gg          , Gs          
