border_size=1
usage=map

Gg          , Gg          , Gg          , Gg          , Gg          , Gg          , Gg          , Gg          , Gg          , Gg          , Gg          , Gg          , Gg          , Gg          , Gg          , Gg          , Gg          , Gg          , Gg          , Gg          , Gg          , Gg          , Gg          , Gg          , Gg          , Gg          , Gg          , Gg          , Gg          , Gg          , Gg          , Gg          , Gg          , Gg          , Hh          
Gg          , Gg          , Gg          , Hh          , Gg          , Hh          , Gg          , Gg          , Gg          , Gg          , Gg          , Gg          , Gg          , Gg          , Gg          , Gg          , Gg          , Gg          , Gg          , Gg          , Gg          , Gg^Vh       , Gg          , Gg          , Gg          , Gg          , Gg          , Gg          , Gg          , Gg          , Gg          , Gg          , Gg          , Gg          , Gg          
Gg          , Hh          , Gg^Efm         , Hh          , Hh          , Gg          , Hh          , Hh          , Gg          , Hh          , Gg          , Gg          , Gg          , Gg          , Gg          , Gg          , Gg          , Gg          , Gg          , Gg          , Gg          , Gg          , Gg          , Gg          , Gg          , Gg          , Ds          , Gg          , Gg          , Gg          , Gg          , Gg          , Gg          , Gg          , Gg          
Gg          , Gg          , Hh          , Gg          , Gg          , Gg          , Hh          , Gg          , Hh          , Hh          , Hh          , Gg          , Hh          , Hh          , Gg          , Hh          , Gg          , Hh          , Hh          , Gg          , Gg          , Gg          , Gg          , Gg          , Gg          , Gg          , Gg          , Gg          , Ce          , Gg          , Gg          , Gg          , Gg          , Gg          , Gg          
Gg          , Gg          , Gg          , Gg          , Gg          , Gg          , Gg          , Gg          , Gs^Fp       , Hh          , Hh          , Hh          , Hh          , Gg          , Gg          , Gg          , Gg          , Gg          , Hh          , Gg          , Gg          , Gg          , Gg          , Gg          , Gg          , Gg          , Gg          , Ce          , 1 Ke        , Ce          , Gg          , Gg          , Gg          , Gg          , Gg          
Gg          , Gg          , Gg          , Gg          , Hh          , Gs^Fp       , Gg          , Gg          , Gg          , Hh          , Gg          , Hh          , Hh          , Gg          , Gg          , Gg          , Gg          , Gg          , Hh          , Gg          , Gg          , Hh          , Ds          , Gg          , Gg          , Gg          , Gg          , Ce          , Ce          , Ce          , Gg          , Gg          , Gg          , Gg          , Gg          
Gg          , Gg          , Gg          , Gg          , Gg          , Gg          , Gg          , Gg          , Gg          , Gg          , Hh          , Gg          , Gg          , Gs^Fp       , Gg          , Gg          , Gg          , Gg          , Gg          , Gg          , Gg          , Hh          , Gg          , Gg          , Hh          , Gg          , Gg          , Gg          , Gs^Fp       , Gg          , Gg          , Gg          , Gg          , Gg          , Hh          
Hh          , Gg          , Gg          , Hh          , Gs^Fp       , Gg          , Gg          , Gg          , Gg          , Gg          , Gg          , Gg          , Gg          , Gg          , Gg          , Gs^Fp       , Gg          , Hh          , Hh          , Hh          , Hh          , Hh          , Gg          , Gg^Efm         , Gg          , Gg          , Gs^Fp       , Hh          , Gg          , Gg          , Gg          , Gs^Fp       , Gg          , Gs^Fp       , Gg          
Gg          , Gg          , Gg          , Gg          , Gs^Fp       , Gg          , Gs^Fp       , Gg          , Gg          , Hh          , Hh          , Gg          , Gg          , Hh          , Gg          , Gg          , Gs^Fp       , Hh          , Hh          , Hh          , Hh          , Gg          , Hh          , Gg          , Hh          , Hh          , Gs^Fp       , Hh          , Gg          , Hh          , Hh          , Gg          , Gg          , Gg          , Gg          
Gg          , Gg          , Gg          , Gg          , Ds          , Gg          , Gg          , Gg          , Gg          , Gg          , Gg          , Gg          , Gg          , Gg          , Gg          , Gg          , Hh          , Gg          , Hh          , Hh          , Hh          , Gg          , Gg          , Hh          , Hh          , Gg          , Gs^Fp       , Gg          , Gg          , Hh          , Hh          , Hh          , Gg          , Gg          , Gg          
Gg          , Gg          , Gg          , Ds          , Gg          , Gg          , Ds          , Gg          , Gg          , Hh          , Gg          , Gs^Fp       , Gg          , Hh          , Gs^Fp       , Hh          , Hh          , Gg          , Hh          , Gg          , Gg          , Hh          , Hh          , Gg          , Gg          , Gg          , Hh          , Hh          , Gg          , Hh          , Gg          , Gg          , Gg^Vh       , Hh          , Gg          
Gg          , Ds          , Gg          , Gg          , Gg          , Gg          , Gg          , Gg          , Gg          , Gg          , Gg          , Gg          , Gg          , Gg          , Hh          , Hh          , Hh          , Ds          , Gg          , Hh          , Gg          , Hh          , Ds          , Hh          , Hh          , Hh          , Hh          , Hh          , Hh          , Gg          , Gg          , Gg          , Gg          , Gg          , Gg          
Gg          , Gg          , Gg          , Gg          , Gg          , Gg          , Gg          , Gg          , Gg          , Gg          , Re          , Re          , Re          , Re          , Gg          , Hh          , Gg^Vh       , Hh          , Hh          , Hh          , Gs^Fp       , Hh          , Gg          , Hh          , Gg          , Hh          , Gs^Fp       , Hh          , Gg          , Hh          , Gg          , Gg          , Gg          , Gg          , Hh          
Gg          , Gg          , Ds          , Gg          , Gg          , Gg          , Re          , Gg          , Re          , Re          , Gg          , Gg          , Gg          , Gg          , Gg          , Hh          , Hh          , Hh          , Gg          , Hh          , Gg          , Hh          , Hh          , Ds          , Gg          , Hh          , Hh          , Hh          , Gg          , Hh          , Gg          , Hh          , Hh          , Gg          , Hh          
Gg          , Gg          , Gg          , Gg          , Gg          , Re          , Re          , Re          , Ds          , Gg          , Gg          , Gg          , Gg          , Gg          , Gg          , Gg          , Gg          , Gg          , Hh          , Gg          , Gg          , Gs^Fp       , Gg          , Hh          , Gg          , Hh          , Hh          , Gg          , Gg          , Gg          , Gg          , Gg          , Hh          , Gg          , Gg          
Gg          , Gg          , Gg          , Gg          , Gg          , Re          , Gg          , Gg          , Gg          , Gg          , Gg          , Gg          , Gg          , Gg          , Gg          , Gg          , Gg          , Gg          , Gg          , Hh          , Hh          , Gg          , Gg          , Hh          , Hh          , Gg          , Hh          , Hh          , Hh          , Gs^Fp       , Gs^Fp       , Hh          , Gg          , Gg          , Gg          
Gg          , Gg          , Ch          , Gg          , Re          , Re          , Gg          , Ds          , Gg          , Gg          , Gg          , Gg          , Gg          , Gg          , Gg          , Gg          , Gg          , Gs^Fp       , Gg          , Gg          , Gg          , Gg          , Gg          , Gg          , Gg          , Gg          , Hh          , Gg          , Hh          , Gg          , Gg          , Hh          , Gg          , Gg          , Gg          
Gg          , Ch          , 3 Kh        , Ch          , Gg          , Gg          , Gg          , Gg          , Gg          , Gg          , Gg^Vh       , Gg          , Gg          , Gg          , Gs^Fp       , Gg          , Gg          , Gg          , Gs^Fp       , Gg          , Gg          , Hh          , Gg          , Gg          , Hh          , Gg          , Gg          , Gg          , Hh          , Gg          , Hh          , Hh          , Gg          , Gg          , Gg          
Gg          , Ch          , Ch          , Ch          , Gg          , Gg          , Gg          , Gg          , Gg          , Gg          , Gg          , Gg          , Gg          , Gg          , Gg          , Gg          , Gg          , Gg          , Gg          , Gg          , Gg          , Gg          , Gs^Fp       , Gg          , Gg          , Gg          , Gg          , Gg          , Gg          , Gg          , Hh          , Gg          , Gg          , Gg          , Gg          
Gg          , Gg          , Gg          , Gg          , Re          , Gg          , Gg          , Gg          , Gg          , Gg          , Gg          , Gg          , Gg          , Gs^Fp       , Gg          , Gg          , Gg          , Gg          , Hh          , Hh          , Gg          , Gg          , Gg          , Hh          , Gg          , Gg          , Gg          , Gg          , Gg          , Gg          , Hh          , Gg          , Gg          , Gg          , Gg          
Gg          , Ds          , Ds          , Gg          , Gg          , Re          , Re          , Gg          , Gg          , Gg          , Gg          , Gg          , Gg          , Gs^Fp       , Gs^Fp       , Hh          , Gg          , Hh          , Gs^Fp       , Gg          , Gg          , Hh          , Gg          , Gg          , Gg          , Gs^Fp       , Gg          , Hh          , Gg          , Gg          , Gg          , Gg          , Gg          , Gg          , Gg          
Gg          , Ds          , Ds          , Ds          , Ds          , Gg          , Gg          , Re          , Re          , Gg          , Gg          , Gg          , Hh          , Gg          , Hh          , Gg          , Gg^Efm         , Gg          , Gg          , Gg          , Gg          , Hh          , Gs^Fp       , Gg          , Hh          , Gg          , Gs^Fp       , Gg          , Hh          , Gg          , Gg          , Gg          , Gg          , Gg          , Gg          
Gg          , Ds          , Ds          , Gg          , Ds          , Gg          , Gg          , Gg          , Gg          , Hh          , Re          , Gg          , Gg          , Gg          , Gg          , Gg          , Gg          , Gg          , Gg          , Gg          , Hh          , Gg          , Hh          , Gg          , Gg          , Gs^Fp       , Gg          , Hh          , Re          , Re          , Gg          , Gg          , Gg          , Gg          , Gg          
Gg          , Ds          , Ds          , Gg          , Ds          , Gg          , Gg          , Gg          , Hh          , Hh          , Re          , Re          , Hh          , Gg          , Hh          , Gg          , Gg          , Gg          , Gg          , Hh          , Ds          , Ds          , Gg          , Gg          , Gg          , Hh          , Gg          , Gg          , Re          , Re          , Hh          , Gg          , Gg          , Gg          , Gg          
Gg          , Ds          , Ds          , Ds          , Ds          , Gg          , Gg          , Gg          , Gg          , Hh          , Gs^Fp       , Gg          , Gg          , Re          , Re          , Gg          , Gg          , Gg          , Gg          , Gg          , Gg          , Gg          , Gg          , Gg          , Hh          , Gg          , Hh          , Gg          , Gg          , Re          , Gg          , Gg          , Hh          , Gg          , Gg          
Gg          , Ds          , Ds          , Ds          , Ds          , Ds          , Gs^Fp       , Gg          , Gg          , Gg          , Gg          , Hh          , Gg          , Gs^Fp       , Gg          , Re          , Gg          , Hh          , Gg          , Gg^Vc       , Gg          , Gg          , Hh          , Hh          , Hh          , Gg          , Gg          , Gg          , Hh          , Re          , Hh          , Gg          , Gg          , Gg          , Gg          
Gg          , Dd          , Dd^Do       , Hh          , Hh          , Dd^Vda      , Hh          , Hh          , Gg          , Hh          , Gg          , Hh          , Gg          , Gg          , Gg          , Gs^Fp       , Ch          , Hh          , Gg          , Gg          , Gg          , Gg^Efm         , Hh          , Hh          , Gg          , Hh          , Hh          , Gg          , Hh          , Re          , Hh          , Gg          , Gg          , Gg          , Gg          
Gg          , Dd          , Dd          , Hh          , Gs^Fp       , Gg          , Gg          , Gg          , Gg          , Hh          , Gg          , Gg          , Hh          , Gg          , Gg          , Ch          , Ch          , Ch          , Ch          , Gg          , Gg          , Gg          , Hh          , Gg          , Gg          , Gg          , Gg          , Gg          , Gg          , Re          , Gg          , Gg          , Gg          , Gg          , Gg          
Mm          , Mm          , Mm          , Hh          , Gs^Fp       , Gg          , Hh          , Gg          , Hh          , Gg          , Hh          , Gg          , Hh          , Gg          , Gg          , Gg          , Gg          , 4 Kh        , Re          , Gg          , Gg          , Gg          , Gg          , Gg          , Hh          , Gg          , Gg          , Gg          , Re          , Hh          , Hh          , Hh          , Gg          , Gg          , Gg          
Mm          , Mm          , Mm          , Mm          , Gs^Fp       , Gg          , Hh          , Gg          , Hh          , Gg          , Gg          , Hh          , Gg          , Gg          , Hh          , Gg          , Gg          , Hh          , Hh          , Hh          , Ds          , Ds          , Re          , Gg          , Gg          , Gg          , Gg          , Hh          , Gg          , Hh          , Gg          , Gg          , Gg          , Gg          , Gg          
Mm          , Mm          , Mm          , Mm          , Mm          , Mm          , Mm          , Hh          , Gg          , Gg          , Gg          , Gg          , Gg          , Gg          , Gg          , Gg          , Gg          , Gg          , Gg          , Hh          , Gg          , Re          , Gg          , Re          , Re          , Re          , Hh          , Gg          , Gg          , Gg          , Gg          , Gg          , Gg          , Gg          , Gg          
Mm          , Mm          , Mm          , Mm          , Mm          , Mm          , Mm          , Gg          , Gg          , Gg          , Hh          , Gg          , Hh          , Gg          , Gg          , Hh          , Gg          , Hh          , Gg          , Gg          , Gs^Fp       , Hh          , Gg          , Gg          , Gg          , Re          , Gg          , Re          , Re          , Gg          , Gg          , Gg          , Gg          , Gg          , Gg          
Mm          , Mm          , Mm          , Mm          , Mm          , Hh          , Mm          , Gg          , Gg          , Gg          , Gg          , Hh          , Hh          , Hh          , Hh          , Gg          , Gg          , Gg          , Gs^Fp       , Gs^Fp       , Gs^Fp       , Hh          , Gs^Fp       , Gg          , Hh          , Gg          , Gg          , Gg          , Re          , Gg          , Gg^Vc       , Gg          , Gg          , Gg          , Gg          
Mm          , Mm          , Mm          , Mm          , Mm          , Mm          , Mm          , Mm          , Gg^Vc       , Gg          , Hh          , Gg          , Gg          , Gg          , Hh          , Gg          , Hh          , Gg          , Hh          , Gg          , Gg          , Gs^Fp       , Gs^Fp       , Hh          , Gg          , Gg          , Gg          , Gg          , Gg          , Re          , Gg          , Gg          , Gg          , Gg          , Gg          
Mm          , Mm          , Mm          , Mm          , Mm          , Mm          , Mm          , Mm          , Mm          , Gg          , Hh          , Gg          , Gg          , Gg          , Gg          , Gg          , Gg          , Hh          , Hh          , Gs^Fp       , Gs^Fp       , Gg          , Gs^Fp       , Gs^Fp       , Gs^Fp       , Gs^Fp       , Gs^Fp       , Gg          , Gg          , Re          , Re          , Gg          , Gg          , Gg          , Gg          
Mm          , Mm          , Mm          , Mm          , Mm          , Mm          , Mm          , Mm          , Mm          , Mm          , Mm          , Gg          , Hh          , Gg          , Gg          , Gg          , Hh          , Gg          , Gg          , Gs^Fp       , Gg          , Gs^Fp       , Gs^Fp       , Gs^Fp       , Gs^Fp       , Gs^Fp       , Gg          , Hh          , Gg          , Gg          , Ch          , Gg          , Gg          , Gg          , Gg          
Mm          , Mm          , Mm          , Mm          , Mm          , Mm          , Mm          , Mm          , Mm          , Mm          , Mm          , Mm          , Mm          , Gg          , Gg          , Gg          , Gg          , Gg          , Gg          , Gg          , Gs^Fp       , Gs^Fp       , Hh          , Gg          , Gg          , Gs^Fp       , Gs^Fp       , Gg          , Gg          , Ch          , 2 Kh        , Ch          , Gg          , Gg          , Gg          
Gg          , Mm          , Mm          , Mm          , Mm          , Mm          , Mm          , Mm          , Mm          , Mm          , Mm          , Mm          , Mm          , Gg          , Gg          , Gg          , Gg          , Gg^Vc       , Hh          , Gg          , Gg          , Gg          , Mm          , Gs^Fp       , Gg          , Gs^Fp       , Gg          , Gg          , Gg          , Ch          , Ch          , Ch          , Gg          , Gg          , Gg          
Gg          , Mm          , Mm          , Mm          , Mm          , Mm          , Mm          , Mm          , Mm          , Mm          , Mm          , Mm          , Mm          , Ch          , Re          , Gg          , Ch          , Mm          , Mm          , Hh          , Mm          , Mm          , Mm          , Mm          , Mm          , Gg          , Gg          , Hh          , Gg          , Gg          , Gg          , Gg          , Gg          , Gg          , Gg          
Mm          , Mm          , Mm          , Mm          , Mm          , Mm          , Mm          , Mm          , Mm          , Mm          , Mm          , Mm          , Re          , Re          , Re          , Re          , Mm          , Mm          , Mm          , Mm          , Mm          , Mm          , Mm          , Mm          , Mm          , Mm          , Mm          , Mm          , Mm          , Gg          , Gg          , Gg          , Gg          , Gg          , Gg          
Mm          , Mm          , Mm          , Mm          , Mm          , Mm          , Mm          , Mm          , Mm          , Mm          , Re          , Re          , Re          , Re          , Mm          , Mm          , Mm          , Mm          , Mm          , Mm          , Mm          , Mm          , Mm          , Mm          , Mm          , Mm          , Ds          , Mm          , Mm          , Mm          , Mm          , Mm          , Mm          , Gg          , Gg          
Mm          , Mm          , Mm          , Mm          , Mm          , Mm          , Mm          , Mm          , Re          , Re          , Re          , Re          , Mm          , Mm          , Mm          , Mm          , Mm          , Mm          , Mm          , Mm          , Mm          , Mm          , Mm          , Mm          , Mm          , Mm          , Mm          , Mm          , Mm          , Mm          , Mm          , Mm          , Mm          , Mm          , Gg          
Mm          , Mm          , Mm          , Mm          , Mm          , Mm          , Re          , Re          , Re          , Re          , Mm          , Mm          , Mm          , Mm          , Mm          , Mm          , Mm          , Mm          , Mm          , Mm          , Mm          , Mm          , Mm          , Mm          , Mm          , Mm          , Mm          , Mm          , Mm          , Mm          , Mm          , Mm          , Mm          , Mm          , Gg          
Mm          , Mm          , Mm          , Mm          , Re          , Re          , Re          , Re          , Mm          , Mm          , Mm          , Mm          , Mm          , Mm          , Mm          , Mm          , Mm          , Mm          , Mm          , Mm          , Mm          , Mm          , Mm          , Mm          , Mm          , Mm          , Mm          , Mm          , Mm          , Mm          , Mm          , Mm          , Mm          , Mm          , Gg          
Mm          , Mm          , Mm          , Mm          , Mm          , Re          , Mm          , Mm          , Mm          , Mm          , Mm          , Mm          , Mm          , Mm          , Mm          , Mm          , Mm          , Mm          , Mm          , Mm          , Mm          , Mm          , Gg          , Mm          , Gg          , Mm          , Mm          , Mm          , Mm          , Mm          , Mm          , Mm          , Mm          , Mm          , Gg          
