Mm, Mm, Mm, Mm, Mm, Mm, Mm, Mm, Mm, Mm, Mm, Mm, Mm, Gg, Gg, Gg, Gs, Gs, Ww, Gs, Gs, Gs, Ww, Gg, Gs, Gs, Gs, Gg, Gg
Mm, Mm, Mm, Mm, Mm, Mm, Mm, Mm, Mm, Mm, Mm, Mm, Mm, Mm, Hh, Gs, Rd, Ww, Ww, Ww, Ww, Ww, Gs, Ww, Gs, Gs, Hh, Rd, Rd
Mm, Mm, Mm, Mm, Mm, Mm, Mm, Mm, Gg^Ve, Mm, Mm, Mm, Mm, Mm, Rd, Rd, Rd, Ww, Hh, Gs, Hh, Hh^Vhh, Hh, Gs, Hh, Hh, Rd, Rd, Rd
Mm, Mm, Mm, Mm, Mm, Mm, Mm, Mm, Mm, Mm, Mm, Mm, Ww, Gs^Ft, Rd, Rd, Hh, Rd, Hh, Hh, Chr, Hh, Chr, Hh, Chr, Hh, Rd, Rd, Rd
Mm, Mm, Mm, Mm, Mm, Mm, Mm, Mm, Mm, Mm, Ww, Ww, Ww, Gs^Ft, Rd, Rd, Rd, Rd, Hh, Chr, Chr, Chr, 1 Khr, Chr, Chr, Hh, Rd, Rd, Gg
Mm, Mm, Mm, Mm, Mm, Mm, Mm, Mm, Mm, Ww, Ww, Ww, Ww, Gs, Re, Rd, Hh^Vhh, Hh, Gs, Hh, Hh, Chr, Chr, Chr, Hh, Hh, Rd, Rd, Gg
Mm, Mm, Mm, Mm, Mm, Mm, Mm, Mm, Mm, Ww, Ww, Gs, Gs^Ft, Wwf^Bw/, Ww, Re, Gs, Gs, Gs^Ft, Hh, Re, Hh, Wwf, Hh, Hh^Vhh, Gs, Gs, Gs, Gg
Mm, Mm, Mm, Mm, Mm, Mm, Mm, Mm, Rd, Re, Gs, Gs, Hh^Vhh, Hh, Re, Ww, Ww, Gs^Ft, Gs^Ft, Gs^Ft, Wwf, Wwf, Mm, Re, Gs, Gs, Mm, Gs, Gg
Mm, Mm, Mm, Mm, Mm, Mm, Mm, Mm, Rd, Rd, Hh, Hh, Hh, Hh, Hh, Ww, Ww, Gs^Ft, Wwf, Wwf, Mm, Mm, Mm, Mm, Mm, Mm, Mm, Mm, Mm
Mm, Mm, Mm, Mm, Mm, Mm, Mm, Mm, Rd, Rd, Rd, Rd, Hh, Hh, Hh, Gs^Ft, Ww, Ww, Mm, Mm, Mm, Mm, Mm, Mm, Mm, Mm, Mm, Mm, Mm
Mm, Mm, Mm, Mm, Mm, Mm, Ww, Gs^Ft, Rd, Rd, Hh, Hh, Hh, Hh^Vhh, Rd, Hh, Gs^Ft, Ww, Mm, Mm, Mm, Mm, Mm, Mm, Mm, Mm, Mm, Mm, Mm
Mm, Mm, Mm, Mm, Ww, Ww, Ww, Gs^Ft, 3 Kh, Ch, Ch, Hh, Rd, Rd, Rd, Rd, Hh, Mm, Mm, Mm, Mm, Mm, Mm, Mm, Mm, Mm, Mm, Mm, Mm
Mm, Mm, Mm, Mm, Ww, Ww, Gs, Ch, Gg^Vh, Rd, Gg^Vh, Ch, Ch, Re^Tf, Re^Tf, Rd, Hh, Mm, Mm, Mm, Mm, Mm, Mm, Mm, Mm, Mm, Mm, Mm, Mm
Mm, Mm, Mm, Mm, Gs, Gs, Ch, Ch, Ch, Rd, Ch, Ch, Gg^Vh, Ch, Ch, Rd, Rd, Mm, Mm, Mm, Mm, Mm, Mm, Mm, Mm, Mm, Mm, Mm, Mm
Mm, Mm, Mm, Mm, Hh, Hh, Ch, Gg^Vh, Rd, Ch, 2 Kh, Ch, Rd, Rd, 4 Kh, Hh, Rd, Rd, Mm, Mm, Mm, Mm, Mm, Mm, Mm, Mm, Mm, Mm, Mm
Mm, Mm, Mm, Mm, Gs^Ft, Hh, 5 Kh, Rd, Gg^Vh, Ch, Ch, Ch, Ch, Gg^Vh, Ch, Rd, Rd, Hh^Vhh, Mm, Mm, Mm, Mm, Mm, Mm, Mm, Mm, Mm, Mm, Mm
Mm, Mm, Mm, Mm, Gs^Ft, Hh, Hh, Ch, Ch, Ch, Gg^Vh, Rd, Gg^Vh, Ch, Hh, Rd, Mm, Mm, Mm, Mm, Mm, Mm, Mm, Mm, Mm, Mm, Mm, Mm, Mm
Mm, Mm, Mm, Mm, Mm, Mm, Mm, Hh, Re^Tf, Ch, Ch, Rd, Ch, Ch, Gs, Gs, Gs^Ft, Gs^Ft, Gs^Ft, Mm, Mm, Mm, Mm, Mm, Mm, Mm, Mm, Mm, Gg
Mm, Mm, Mm, Mm, Mm, Mm, Mm, Mm, Mm, Rd, Rd, 6 Kh, Gs, Gs, Gs^Ft, Gs^Ft, Gs^Ft, Gs^Ft, Gs^Ft, Mm, Mm, Mm, Mm, Mm, Mm, Mm, Mm, Mm, Mm
Mm, Mm, Mm, Mm, Mm, Mm, Mm, Mm, Mm, Mm, Rd, Gs, Ww, Ww, Mm, Gs^Ft, Mm, Mm, Mm, Mm, Mm, Mm, Mm, Mm, Mm, Mm, Mm, Mm, Mm
Mm, Mm, Mm, Mm, Mm, Mm, Mm, Mm, Mm, Mm, Mm, Mm, Mm, Mm, Mm, Mm, Mm, Mm, Mm, Mm, Mm, Mm, Mm, Mm, Mm, Mm, Mm, Mm, Mm
Mm, Mm, Mm, Mm, Mm, Mm, Mm, Mm, Mm, Mm, Mm, Mm, Mm, Mm, Mm, Mm, Mm, Mm, Mm, Mm, Mm, Mm, Mm, Mm, Mm, Mm, Mm, Mm, Mm
Mm, Mm, Mm, Mm, Mm, Mm, Mm, Mm, Mm, Mm, Mm, Mm, Mm, Mm, Mm, Mm, Mm, Mm, Mm, Mm, Mm, Mm, Mm, Mm, Mm, Mm, Mm, Mm, Gg
Mm, Mm, Mm, Mm, Mm, Mm, Mm, Mm, Mm, Mm, Mm, Mm, Mm, Mm, Mm, Mm, Mm, Mm, Mm, Mm, Mm, Mm, Mm, Mm, Mm, Mm, Mm, Mm, Gg
Mm, Mm, Mm, Mm, Mm, Mm, Mm, Mm, Mm, Mm, Mm, Mm, Mm, Mm, Mm, Mm, Mm, Mm, Mm, Mm, Mm, Mm, Mm, Mm, Mm, Mm, Mm, Mm, Gg
Mm, Mm, Mm, Mm, Mm, Mm, Mm, Mm, Mm, Mm, Mm, Mm, Mm, Mm, Mm, Mm, Mm, Mm, Mm, Mm, Mm, Mm, Mm, Mm, Mm, Mm, Mm, Mm, Mm
Mm, Mm, Mm, Mm, Mm, Mm, Mm, Mm, Mm, Mm, Mm, Mm, Mm, Mm, Mm, Mm, Mm, Mm, Mm, Mm, Mm, Mm, Mm, Mm, Mm, Mm, Mm, Mm, Mm
Mm, Mm, Mm, Mm, Mm, Mm, Mm, Mm, Mm, Mm, Mm, Mm, Mm, Mm, Mm, Mm, Mm, Mm, Mm, Mm, Mm, Mm, Mm, Mm, Mm, Mm, Mm, Mm, Mm
Gg, Mm, Mm, Mm, Mm, Mm, Mm, Mm, Mm, Mm, Mm, Mm, Mm, Mm, Mm, Mm, Mm, Mm, Mm, Mm, Mm, Mm, Mm, Mm, Mm, Mm, Mm, Mm, Mm
