Xu, Xu, Xu, Rr, Xu, Rr, Xu, Rr, Xu, Rr, Xu, Rr, Xu, Rr, Xu, Xu, Ch, Ch, Ch, Ch, Ch, Ch, Ch, Ch, Ch, Ch, Ch, Ch, Ch, Ch, Ch, Ch, Xu, Xu, Xu, Xu, Xu, Xu, Xu, Xu, Xu, Xu
Xu, Xu, Rr, Xu, Rr, Xu, Rr, Xu, Rr, Xu, Rr, Xu, Rr, Xu, Rr, Rr, Ch, Ch, Ch, Ch, Ch, Ch, Ch, Ch, Ch, Ch, Ch, Ch, Ch, Ch, Ch, Ch, Xu, Xu, Rr, Xu, Rr, Xu, Rr, Xu, Xu, Xu
Xu, Xu, Rr, Rr, Rr, Rr, Rr, Rr, Rr, Rr, Rr, Dd^Dr, Rr, Xu, Rr, Rr, Ch, Ch, Ch, Ch, Ch, Ch, Ch, Ch, Ch, Ch, Ch, Ch, Ch, Ch, Ch, Ch, Xu, Rr, Rr, Rr, Rr, Rr, Rr, Rr, Xu, Xu
Xu, Xu, Rr, Rr, Rr, Chr, Rr, Rr, Rr, Rr, Rr, Rr, Rr, Xu, Rr, Rr, Ch, Ch, Ch, Ch, Ch, Ch, Ch, Ch, Ch, Ch, Ch, Ch, Ch, Ch, Ch, Ch, Xu, Rr, Rr, Rr, Rr, Rr, Rr, Rr, Xu, Xu
Xu, Xu, Rr, Rr, Dd^Dr, Rr, Rr, Rr, Rr, Rr, Rr, Rr, Rr, Xu, Rr, Rr, Ch, Ch, Ch, Ch, Ch, Ch, Ch, Ch, Ch, Ch, Ch, Ch, Ch, Ch, Ch, Ch, Xu, Rr, Rr, Rr, Rr, Rr, Rr, Rr, Xu, Xu
Xu, Xu, Rr, Rr, Rr, Rr, Rr, Rr, Rr, Dd^Dr, Rr, Chr, Rr, Xu, Rr, Rr, Ch, Ch, Ch, Ch, Ch, Ch, Ch, Ch, Ch, Ch, Ch, Ch, Ch, Ch, Ch, Ch, Xu, Rr, Rr, Rr, 6 Kh, Rr, Rr, Rr, Xu, Xu
Xu, Xu, Xu, Rr, Rr, Rr, Rr, Rr, Rr, Rr, Rr, Rr, Xu, Xu, Xu, Rr, Xu, Ch, Ch, Ch, Ch, Ch, Ch, Ch, Ch, Ch, Ch, Ch, Ch, Ch, Ch, Ch, Xu, Rr, Rr, Rr, Rr, Rr, Rr, Rr, Xu, Xu
Xu, Xu, Xu, Xu, Xu, Rr, Rr, Rr, Rr, Rr, Xu, Xu, Xu, Xu, Xu, Xu, Xu, Xu, Xu, Xu, Xu, Xu, Xu, Xu, Xu, Ch, Ch, Ch, Xu, Xu, Xu, Xu, Rr, Rr, Rr, Rr, Rr, Rr, Rr, Rr, Xu, Xu
Xu, Xu, Xu, Xu, Xu, Rr, Rr, Rr, Xu, Xu, Xu, Xu, Xu, Xu, Ww, Xu, Xu, Xu, Xu, Xu, Xu, Xu, Xu, Xu, Xu, Xu, Xu, Ch, Ch, Xu, Xu, Xu, Rr, Rr, Rr, Rr, Rr, Rr, Rr, Rr, Xu, Xu
Xu, Xu, Xu, Xu, Xu, Ch, Rr, Ch, Rr, Xu, Xu, Xu, Ww, Ww, Ww, Ww, Ww, Xu, Xu, Xu, Xu, Xu, Xu, Xu, Xu, Xu, Rr, Ch, Ch, Ch, Rr, Xu, Xu, Rr, Rr, Rr, Rr, Rr, Rr, Rr, Xu, Xu
Xu, Xu, Xu, Xu, Xu, Xu, Rr, Rr, Rr, Xu, Xu, Xu, Ww, Ww, Ww, Ww, Ww, Xu, Xu, Xu, Xu, Xu, Xu, Xu, Xu, Xu, Rr, Ch, Ch, 4 Kh, Rr, Rr, Rr, Xu, Xu, Rr, Rr, Rr, Rr, Rr, Xu, Xu
Xu, Xu, Xu, Xu, Xu, Xu, Rr, Rr, Rr, Xu, Xu, Xu, Ww, Ww, Chw, Ww, Ww, Xu, Xu, Xu, Xu, Xu, Xu, Xu, Xu, Xu, Xu, Rr, Rr, Ch, Xu, Rr, Rr, Xu, Kh, Kh, Kh, Rr, Rr, Rr, Xu, Xu
Xu, Xu, Xu, Xu, Xu, Xu, Rr, Rr, Rr, Xu, Xu, Xu, Ww, Chw, Khw, Chw, Ww, Xu, Xu, Xu, Xu, Xu, Xu, Xu, Xu, Xu, Xu, Xu, Rr, Xu, Ch, Ch, Xu, Rr, Rr, Kh, Xu, Xu, Xu, Xu, Xu, Xu
Xu, Xu, Xu, Xu, Xu, Xu, Rr, Rr, Rr, Xu, Xu, Xu, Ww, Chw, Chw, Chw, Ww, Xu, Xu, Xu, Xu, Xu, Xu, Xu, Xu, Xu, Xu, Xu, Rr, Xu, Ch, Ch, Xu, Rr, Rr, Xu, Xu, Xu, Xu, Xu, Xu, Xu
Xu, Xu, Xu, Xu, Xu, Xu, Rr, Rr, Rr, Rr, Rr, Xu, Ww, Ww, Ww, Ww, Ww, Xu, Xu, Xu, Xu, Xu, Xu, Xu, Xu, Xu, Xu, Xu, Rr, Xu, 5 Kh, Ch, Xu, Rr, Rr, Xu, Xu, Xu, Xu, Xu, Xu, Xu
Xu, Xu, Xu, Xu, Xu, Xu, Rr, Rr, Rr, Xu, Xu, Rr, Ww, Ww, Ww, Ww, Ww, Xu, Xu, Xu, Xu, Xu, Xu, Xu, Xu, Xu, Xu, Xu, Rr, Xu, Ch, Ch, Xu, Rr, Rr, Xu, Xu, Xu, Xu, Xu, Xu, Xu
Xu, Xu, Xu, Xu, Xu, Xu, Rr, Rr, Rr, Xu, Xu, Xu, Xu, Ww, Ww, Ww, Xu, Xu, Xu, Xu, Xu, Xu, Xu, Xu, Xu, Xu, Rr, Xu, Rr, Xu, Ch, Ch, Xu, Rr, Rr, Xu, Xu, Xu, Xu, Xu, Xu, Xu
Xu, Xu, Xu, Xu, Xu, Xu, Rr, Rr, Rr, Xu, Xu, Xu, Xu, Xu, Xu, Xu, Xu, Xu, Xu, Xu, Rr, Xu, Rr, Rr, Rr, Rr, Rr, Rr, Rr, Xu, Xu, Ch, Xu, Rr, Xu, Xu, Xu, Xu, Xu, Xu, Xu, Xu
Xu, Xu, Xu, Xu, Xu, Rr, Rr, Rr, Rr, Xu, Xu, Xu, Xu, Xu, Xu, Xu, Xu, Xu, Xu, Rr, Rr, Rr, Rr, Rr, Xu, Xu, Xu, Rr, Rr, Rr, Rr, Rr, Rr, Rr, Xu, Xu, Xu, Xu, Xu, Xu, Xu, Xu
Xu, Xu, Xu, Xu, Ch, Ch, Ch, Rr, Rr, Xu, Xu, Xu, Xu, Xu, Xu, Xu, Xu, Xu, Xu, Rr, Rr, Rr, Xu, Xu, Gg^Efm, Re^Tf, Gs^Fp, Xu, Gg, Rr, Rr, Rr, Rr, Rr, Xu, Xu, Xu, Xu, Xu, Xu, Xu, Xu
Xu, Xu, Xu, Ch, 2 Kh, Ch, Ch, Rr, Rr, Xu, Xu, Xu, Xu, Xu, Xu, Xu, Xu, Xu, Rr, Rr, Rr, Rr, Xu, Gs^Fp, Cv, Gg, Gs, Gg, Re^Tf, Xu, Xu, Rr, Rr, Xu, Xu, Xu, Xu, Xu, Xu, Xu, Xu, Xu
Xu, Xu, Xu, Ch, Ch, Ch, Rr, Rr, Rr, Xu, Xu, Xu, Xu, Xu, Xu, Xu, Xu, Rr, Rr, Rr, Xu, Xu, Re^Tf, Gg, Gs, Gg^Fet, Ds, Ds, Ds, Gs^Ft, Xu, Rr, Rr, Xu, Xu, Xu, Xu, Xu, Xu, Xu, Xu, Xu
Xu, Xu, Xu, Xu, Xu, Rr, Rr, Rr, Rr, Rr, Xu, Xu, Xu, Xu, Xu, Xu, Xu, Rr, Rr, Xu, Gg, Gg, Re^Tf, Gs^Fp, Ww, Ds, Ww, Ww, Ww, Ds, Xu, Rr, Rr, Xu, Xu, Xu, Xu, Xu, Xu, Xu, Xu, Xu
Xu, Xu, Xu, Xu, Xu, Rr, Rr, Rr, Rr, Rr, Xu, Xu, Xu, Xu, Xu, Xu, Rr, Rr, Xu, Xu, Gg, Gs^Fp, Gg, Gg, Ww, Ww, Chw, Ww, Gs^Ft, Xu, Rr, Rr, Rr, Xu, Xu, Xu, Xu, Xu, Xu, Xu, Xu, Xu
Xu, Xu, Xu, Xu, Xu, Rr, Rr, Rr, Rr, Rr, Xu, Xu, Xu, Xu, Xu, Xu, Rr, Rr, Xu, Gg, Gg^Fet, Gg^Efm, Cv, Gs^Fp, Gs^Fp, Ww, Ww, Ww, Ww, Xu, Xu, Rr, Rr, Xu, Xu, Xu, Xu, Xu, Xu, Xu, Xu, Xu
Xu, Xu, Xu, Xu, Xu, Rr, Rr, Rr, Rr, Rr, Xu, Xu, Xu, Xu, Xu, Xu, Rr, Rr, Xu, Gg, Gs^Fp, Gs^Fp, Gg, Gs^Fp, Gs^Fp, Gs^Fp, Gg, Gs^Ft, Gg, Xu, Xu, Rr, Rr, Xu, Xu, Xu, Xu, Xu, Xu, Xu, Xu, Xu
Xu, Xu, Xu, Xu, Xu, Rr, Rr, Rr, Rr, Xu, Xu, Xu, Xu, Xu, Xu, Rr, Rr, Rr, Xu, Gg, Gg, Gg, Re^Tf, Gs^Fp, Gg, Gg^Efm, Gg, Gs^Fp, Gg, Xu, Xu, Rr, Rr, Xu, Xu, Xu, Xu, Xu, Xu, Xu, Xu, Xu
Xu, Xu, Xu, Xu, Rr, Rr, Rr, Rr, Rr, Xu, Xu, Xu, Xu, Xu, Ch, Rr, Rr, Xu, Gg, Gg^Efm, Xu, Gg, Gg^Fet, Gg, Xu, Gg, Xu, Gg, Xu, Xu, Rr, Rr, Rr, Xu, Xu, Xu, Xu, Xu, Xu, Xu, Xu, Xu
Xu, Xu, Xu, Rr, Rr, Rr, Rr, Rr, Rr, Rr, Rr, Rr, Ch, Xu, 3 Kh, Rr, Rr, Xu, Xu, Xu, Rr, Xu, Xu, Xu, Rr, Xu, Rr, Xu, Rr, Rr, Rr, Rr, Rr, Xu, Xu, Xu, Xu, Xu, Xu, Xu, Xu, Xu
Xu, Xu, Xu, Rr, Rr, Rr, Rr, Rr, Rr, Rr, Rr, Rr, Ch, Ch, Ch, Ch, Xu, Rr, Rr, Rr, Rr, Rr, Rr, Rr, Xu, Rr, Xu, Rr, Xu, Rr, Rr, Rr, Rr, Xu, Xu, Xu, Xu, Xu, Xu, Xu, Xu, Xu
Xu, Xu, Xu, Rr, Rr, Rr, Rr, Rr, Xu, Rr, Xu, Rr, Xu, Ch, Rr, Xu, Xu, Xu, Xu, Xu, Xu, Xu, Xu, Xu, Xu, Xu, Xu, Xu, Xu, Xu, Xu, Rr, Xu, Xu, Xu, Xu, Xu, Xu, Xu, Xu, Xu, Xu
Xu, Xu, Xu, Rr, Rr, Rr, Xu, Xu, Xu, Rr, Rr, Xu, Rr, Xu, Xu, Rr, Rr, Xu, Xu, Xu, Xu, Xu, Xu, Xu, Xu, Xu, Xu, Xu, Xu, Xu, Rr, Rr, Rr, Xu, Xu, Xu, Xu, Xu, Xu, Xu, Xu, Xu
Xu, Xu, Xu, Rr, Rr, Rr, Xu, Xu, Xu, Rr, Ch, Rr, Rr, Rr, Rr, Xu, Rr, Xu, Xu, Xu, Xu, Xu, Xu, Xu, Xu, Xu, Xu, Xu, Xu, Rr, Xu, Rr, Rr, Rr, Rr, Xu, Xu, Xu, Xu, Xu, Xu, Xu
Xu, Xu, Xu, Rr, Rr, Rr, Xu, Xu, Xu, Rr, Rr, Rr, Rr, Rr, Rr, Xu, Rr, Xu, Rr, Rr, Rr, Xu, Xu, Xu, Xu, Xu, Xu, Xu, Rr, Rr, Xu, Xu, Rr, Rr, Rr, Xu, Xu, Xu, Xu, Xu, Xu, Xu
Xu, Xu, Xu, Rr, Rr, Rr, Xu, Xu, Xu, Rr, Rr, Rr, Rr, Ch, Rr, Xu, Rr, Rr, Xu, Xu, Xu, Rr, Rr, Xu, Xu, Xu, Rr, Rr, Xu, Xu, Xu, Xu, Xu, Rr, Rr, Rr, Rr, Xu, Xu, Xu, Xu, Xu
Xu, Xu, Xu, Rr, Rr, Rr, Xu, Xu, Xu, Rr, Rr, Rr, Rr, Rr, Xu, Xu, Xu, Xu, Ce, Ce, Ce, Xu, Xu, Rr, Rr, Xu, Rr, Xu, Rr, Xu, Rr, Xu, Xu, Xu, Rr, Rr, Rr, Xu, Xu, Xu, Xu, Xu
Xu, Xu, Xu, Rr, Rr, Rr, Xu, Xu, Xu, Xu, Xu, Rr, Xu, Xu, Xu, Xu, Xu, Ce, Ce, Ce, Ce, Ce, Xu, Xu, Xu, Rr, Rr, Xu, Rr, Rr, Rr, Xu, Xu, Xu, Rr, Rr, Xu, Xu, Xu, Xu, Xu, Xu
Xu, Xu, Xu, Rr, Rr, Rr, Xu, Xu, Xu, Xu, Rr, Xu, Rr, Xu, Xu, Xu, Xu, Ce, Ce, Ce, Ce, Ce, Rr, Rr, Rr, Xu, Xu, Xu, Rr, Ce, Rr, Xu, Rr, Rr, Xu, Xu, Xu, Xu, Xu, Xu, Xu, Xu
Ce, Xu, Xu, Ch, Rr, Ch, Xu, Xu, Xu, Xu, Rr, Rr, Rr, Ce, Xu, Xu, Xu, Ce, Ce, Ce, Ce, Ce, Xu, Xu, Xu, Rr, Rr, Rr, Rr, Rr, Rr, Rr, Xu, Xu, Xu, Xu, Xu, Xu, Xu, Xu, Xu, Xu
Ce, Ce, 1 Ke, Ce, Xu, Ch, Rr, Xu, Xu, Rr, Rr, Ce, Rr, Rr, Rr, Xu, Rr, Rr, Xu, Ce, Ce, Ce, Xu, Rr, Rr, Xu, Xu, Rr, Rr, Ce, Rr, Xu, Xu, Xu, Xu, Xu, Xu, Xu, Xu, Xu, Xu, Xu
Ce, Ce, Ce, Ce, Ce, Xu, Xu, Rr, Rr, Rr, Xu, Rr, Xu, Rr, Xu, Rr, Xu, Xu, Rr, Xu, Xu, Xu, Rr, Rr, Rr, Rr, Rr, Xu, Xu, Rr, Xu, Xu, Xu, Xu, Xu, Xu, Xu, Xu, Xu, Xu, Xu, Xu
Ce, Ce, Ce, Ce, Ce, Ce, Ce, Xu, Xu, Xu, Rr, Xu, Rr, Xu, Rr, Xu, Rr, Rr, Rr, Rr, Rr, Rr, Rr, Rr, Rr, Rr, Rr, Rr, Rr, Xu, Xu, Xu, Xu, Xu, Xu, Xu, Xu, Xu, Xu, Xu, Xu, Xu
