border_size=1
usage=map

Xu          , Xu          , Xu          , Xu          , Xu          , Xu          , Xu          , Xu          , Xu          , Xu          , Xu          , Xu          , Xu          , Xu          , Xu          , Xu          , Xu          , Xu          , Xu          , Xu          , Xu          , Xu          , Xu          , Xu          , Xu          , Xu          , Xu          , Xu          , Xu          , Xu          , Xu          , Xu          , Xu          
Xu          , Xu          , Xu          , Xu          , Xu          , Xu          , Xu          , Xu          , Xu          , Xu          , Xu          , Xu          , Xu          , Xu          , Xu          , Xu          , Gg^Vc       , Xu          , Xu          , Xu          , Xu          , Xu          , Xu          , Xu          , Xu          , Xu          , Xu          , Xu          , Xu          , Xu          , Xu          , Xu          , Xu          
Xu          , Xu          , Qlf         , Qlf         , Rd          , Rr          , Uh^Ii       , Rr          , Uu^Uf       , Rr          , Rd          , Rr          , Rd          , Rr          , Wwf         , Rr          , Wwf         , Rr          , Rr          , Gg^Vc       , Rd          , Rr          , Ww          , Rr          , Rr          , Rr          , Ww          , Ww          , Rr          , Rr          , Rr          , Xu          , Xu          
Xu          , Xu          , Qlf         , Xv          , Xv          , Rd          , Rr          , Uu^Uf       , Rd          , Rd          , Rr          , Rd          , Rr          , Rd          , Wwf         , Wwf         , Ss          , Wwf         , Wwf         , Rr          , Rd          , Rr          , Rd          , Rr          , Uu^Uf       , Rd          , Rr          , Rd          , Rd          , Uh          , Rr          , Xu          , Xu          
Xu          , Xu          , Qlf         , Uh^Ii       , Xv          , Rd          , Rd          , Rd          , Dd^Dr       , Uh          , Re^Uf       , Ww          , Ww          , Wwf         , Cud         , Ss          , Dd^Dr       , Wwf         , Ss          , Aa          , Uh          , Rd          , Uh          , Ww          , Rr          , Ww          , Uh          , Uh          , Ww          , Uu^Uf       , Uu^Uf       , Xu          , Xu          
Xu          , Xu          , Qlf         , Uh^Ii       , Xv          , Rp          , Xv          , Rr          , Aa^Vea      , Re^Uf       , Aa          , Rr          , Ww          , Cud         , 2 Kud       , Cud         , Dd^Dr       , Dd^Dr       , Aa          , Aa          , Rr          , Uh          , Rr          , Uh          , Re^Uf       , Rr          , Ss          , Rr          , Re^Uf       , Re^Uf       , Uu^Uf       , Xu          , Xu          
Xu          , Xu          , Re^Uf       , Qlf         , Re^Uf       , Xv          , Re^Uf       , Rd          , Uu^Ufi      , Aa          , Aa          , Rr          , Uh          , Cud         , Cud         , Cud         , Re^Uf       , Aa          , Rp          , Rr          , Uu^Ufi      , Uu^Uf       , Ww          , Re^Uf       , Re^Uf       , Re^Uf       , Dd^Dr       , Rr          , Re^Uf       , Rr          , Ww          , Xu          , Xu          
Xu          , Xu          , Rr          , Re^Uf       , Uh          , Re^Uf       , Re^Uf       , Uu^Ufi      , Rr          , Dd^Dr       , Uh          , Uh^Ii       , Uh          , Rr          , Rr          , Rr          , Re^Uf       , Rp          , Xv          , Xv          , Uu^Ufi      , Uu^Uf       , Rp          , Rr          , Rr          , Ss          , Wwf         , Aa          , Rr          , Ww          , Rd          , Xu          , Xu          
Xu          , Xu          , Rr          , Uh          , Uh          , Uh          , Rr          , Ww          , Ww          , Rr          , Rp          , Rr          , Qlf         , Re^Uf       , Re^Uf       , Rr          , Rd          , Rp          , Rr          , Ww          , Ww          , Rr          , Ww          , Rr          , Ss^Vhs      , Wwf         , Aa          , Aa          , Rr          , Rd          , Xv          , Xu          , Xu          
Xu          , Xu          , Rr          , Xv          , Xv          , Re^Uf       , Xv          , Rr          , Rr          , Ww          , Rd          , Qlf         , Rr          , Re^Uf       , Rd          , Rd          , Rr          , Uh^Ii       , Qlf         , Qlf         , Qlf         , Rr          , Rr          , Rr          , Wwf         , Wwf         , Wwf         , Aa          , Uh          , Rd          , Xv          , Xu          , Xu          
Xu          , Xu          , Rr          , Re^Uf       , Xv          , Xv          , Xv          , Uu^Ufi      , Aa          , Aa          , Uh          , Qlf         , Rr          , Re^Uf       , Rr          , Rr          , Re^Uf       , Uh^Ii       , Qlf         , Qlf         , Qlf         , Qlf         , Rr          , Dd^Dr       , Rr          , Rr          , Dd^Dr       , Rr          , Uh          , Xv          , Rd          , Xu          , Xu          
Xu          , Xu          , Rp          , Rr          , Uh^Ii       , Uh^Ii       , Uu^Uf       , Uu^Ufi      , Aa          , Aa          , Uh^Ii       , Rr          , Ww          , Re^Uf       , Ss          , Ss^Vhs      , Rr          , Re^Uf       , Re^Uf       , Re^Uf       , Rr          , Ww          , Uu^Uf       , Rr          , Rd          , Rr          , Qlf         , Uh          , Uh          , Rr          , Rd          , Xu          , Xu          
Xu          , Xu          , Rr          , Rp          , Aa          , Aa          , Aa          , Uu^Ufi      , Wwf         , Wwf         , Ww          , Xv          , Ww          , Rr          , Ss          , Wwf         , Rd          , Rd          , Rr          , Rr          , Ww          , Ww          , Rd          , Rd          , Re^Uf       , Rd          , Rr          , Uh          , Ww          , Rr          , Rr          , Xu          , Xu          
Xu          , Xu          , Ss          , Rp          , Ss          , Rr          , Cud         , Qlf         , Qlf         , Uu^Uf       , Rd          , Xv          , Rd          , Wwf         , Uu^Ufi      , Rd          , Rr          , Rr          , Re^Uf       , Rr          , Ww          , Rr          , Uu^Uf       , Re^Uf       , Aa          , Qlf         , Rr          , Rr          , Rr          , Ww          , Rr          , Xu          , Xu          
Xu          , Xu          , Aa          , Ss          , Aa          , Cud         , 4 Kud       , Cud         , Uu^Uf       , Uu^Uf       , Ss^Vhs      , Xv          , Rr          , Rp          , Rp          , Uu^Ufi      , Aa          , Re^Uf       , Rr          , Rr          , Uu^Vud      , Uu^Uf       , Uh          , Rr          , Rr          , Rr          , Rr          , Aa          , Re^Uf       , Uh          , Rr          , Xu          , Xu          
Xu          , Xu          , Aa          , Aa          , Rd          , Cud         , Cud         , Cud         , Ss          , Ss          , Wwf         , Wwf         , Uu^Uf       , Rr          , Qlf         , Rp          , Rr          , Aa          , Rr          , Rr          , Uh          , Uh          , Rd          , Uh          , Uh          , Rr          , Rd          , Rr          , Rr          , Re^Uf       , Rr          , Xu          , Xu          
Xu          , Xu          , Ss          , Aa          , Rd          , Uh          , Ss          , Ss          , Rr          , Rr          , Wwf         , Uu^Uf       , Uu^Uf       , Qlf         , Uu^Uf       , Qlf         , Rr          , Aa^Vea      , Aa          , Uu^Ufi      , Uh          , Rd          , Dd^Dr       , Rr          , Rr          , Rr          , Wwf         , Rd          , Rd          , Rr          , Rr          , Xu          , Xu          
Xu          , Xu          , Rr          , Ss          , Qlf         , Rd          , Ss^Vhs      , Rr          , Rr          , Dd^Dr       , Dd^Dr       , Rr          , Uu^Uf       , Uu^Uf       , Re^Uf       , Rr          , Rr          , Aa          , Aa          , Uu^Ufi      , Rp          , Uh          , Wwf         , Rr          , Rr          , Dd^Dr       , Rr          , Rd          , Qlf         , Rr          , Rr          , Xu          , Xu          
Xu          , Xu          , Rr          , Ss          , Rr          , Rp          , Uh          , Rr          , Rd          , Rr          , Rd          , Ww          , Rr          , Rr          , Re^Uf       , Re^Uf       , Re^Uf       , Rr          , Wwf         , Rp          , Wwf         , Wwf         , Ss          , Re^Uf       , Re^Uf       , Uh          , Re^Uf       , Rd          , Qlf         , Rr          , Rr          , Xu          , Xu          
Xu          , Xu          , Uh          , Ss          , Ww          , Rp          , Re^Uf       , Aa          , Rr          , Rd          , Rd          , Rd          , Rd          , Rr          , Rr          , Rr          , Uu^Ufi      , Qlf         , Rr          , Wwf         , Aa          , Ss          , Rp          , Rp          , Re^Uf       , Rr          , Re^Uf       , Rd          , Rr          , Qlf         , Rr          , Xu          , Xu          
Xu          , Xu          , Uh          , Rr          , Ww          , Dd^Dr       , Re^Uf       , Rr          , Wwf         , Wwf         , Re^Uf       , Rd          , Xv          , Ss          , Uu^Uf       , Uu^Ufi      , Uh^Ii       , Qlf         , Qlf         , Aa          , Aa          , Ss          , Ss^Vhs      , Aa^Vea      , Rr          , Rr          , Cud         , Xv          , Uh^Ii       , Qlf         , Uh          , Xu          , Xu          
Xu          , Xu          , Rr          , Ss          , Uh^Ii       , Rr          , Re^Uf       , Rr          , Dd^Dr       , Re^Uf       , Xv          , Xv          , Dd^Dr       , Uu^Uf       , Uu^Uf       , Rr          , Rd          , Uh          , Xv          , Aa          , Rr          , Wwf         , Wwf         , Re^Uf       , Re^Uf       , Cud         , 3 Kud       , Cud         , Ss          , Uh^Ii       , Uh          , Xu          , Xu          
Xu          , Xu          , Rr          , Ss          , Uh^Ii       , Wwf         , Rr          , Ss          , Rr          , Re^Uf       , Rr          , Ss          , Uu^Ufi      , Wwf         , Rr          , Ss          , Rr          , Rd          , Rr          , Rp          , Rp          , Dd^Dr       , Rr          , Re^Uf       , Rd          , Cud         , Cud         , Cud         , Dd^Dr       , Ss          , Ss          , Xu          , Xu          
Xu          , Xu          , Ss          , Ss          , Qlf         , Uh^Ii       , Rr          , Ss          , Uh^Ii       , Uu^Vud      , Uh          , Rr          , Aa          , Wwf         , Wwf         , Rr          , Ss          , Re^Uf       , Re^Uf       , Rp          , Rp          , Rp          , Rr          , Rd          , Rd          , Wwf         , Ss          , Aa          , Aa          , Aa          , Xu          , Xu          , Xu          
Xu          , Xu          , Rr          , Ss          , Rr          , Qlf         , Re^Uf       , Uh          , Rp          , Uh          , Rd          , Rd          , Aa^Vea      , Aa          , Rr          , Wwf         , Wwf         , Rr          , Re^Uf       , Re^Uf       , Uh          , Ww          , Ww          , Re^Uf       , Dd^Dr       , Wwf         , Ss          , Aa          , Xu          , Xu          , Ss          , Ss          , Xu          
Xu          , Xu          , Xu          , Rr          , Uu^Uf       , Re^Uf       , Rp          , Dd^Dr       , Rp          , Xv          , Dd^Dr       , Rd          , Uh          , Aa          , Ww          , Ww          , Ww^Vm       , Rr          , Uu^Uf       , Re^Uf       , Rp          , Ww          , Re^Uf       , Rp          , Rr          , Ss          , Xu          , Xu          , Ss          , Ss          , Ss          , Ss          , Xu          
Xu          , Ss          , Ss          , Xu          , Xu          , Re^Uf       , Re^Uf       , Rp          , Re^Uf       , Qlf         , Qlf         , Uh          , Xu          , Rr          , Rd          , Rr          , Rd          , Rr          , Xu          , Rp          , Uh^Ii       , Ww          , Rr          , Rr          , Xu          , Xu          , Ss          , Ss          , Dd^Dr       , Ss          , Xu          , Xu          , Xu          
Xu          , Ss          , Rr          , Ss          , Dd^Dr       , Xu          , Xu          , Re^Uf       , Qlf         , Qlf         , Xu          , Xu          , Rr          , Rr          , Dd^Dr       , Rr          , Rr          , Rr          , Wwf         , Xu          , Xu          , Uh          , Xu          , Xu          , Rr          , Dd^Dr       , Ss          , Ss          , Xu          , Xu          , Xu          , Xu          , Xu          
Xu          , Xu          , Xu          , Rr          , Rr          , Rr          , Rr          , Xu          , Xu          , Xu          , Uu^Uf       , Rr          , Wwf         , Rr          , Uu^Uf       , Rr          , Ss          , Wwf         , Rr          , Rr          , Rr          , Xu          , Rr          , Xv          , Ss          , Ss          , Xu          , Xu          , Xu          , Xu          , Xu          , Xu          , Xu          
Xu          , Xu          , Xu          , Xu          , Xu          , Rr          , Ss          , Rr          , Rr          , Rr          , Uu^Uf       , Uu^Uf       , Ss          , Wwf         , Wwf         , Rd          , Gg^Ve       , Ss          , Ss          , Ss          , Ss          , Rr          , Uu^Uf       , Rr          , Uu          , Xu          , Xu          , Xu          , Xu          , Xu          , Xu          , Xu          , Xu          
Xu          , Xu          , Xu          , Xu          , Xu          , Xu          , Xu          , Rr          , Uu          , Uu^Uf       , Dd^Dr       , Rr          , Rr          , Ss          , Ss          , Re          , Uu^Ii       , Re          , Xu          , Rr          , Xv          , Rr          , Uu^Uf       , Rr          , Uu          , Xu          , Xu          , Xu          , Xu          , Xu          , Xu          , Xu          , Xu          
Xu          , Xu          , Xu          , Xu          , Xu          , Xu          , Xu          , Xu          , Uu          , Rr          , Dd^Dr       , Rr          , Re          , Xu          , Re          , Re          , Re          , Re          , Re          , Rr          , Re          , Uu^Uf       , Rr          , Dd^Dr       , Uu          , Xu          , Xu          , Xu          , Xu          , Xu          , Xu          , Xu          , Xu          
Xu          , Xu          , Xu          , Xu          , Xu          , Xu          , Xu          , Xu          , Uu          , Rr          , Rr          , Dd^Dr       , Uu^Ii       , Re          , Rr          , Xu          , Rr          , Xu          , Rr          , Re          , Uu^Ii       , Dd^Dr       , Rr          , Rr          , Uu^Uf       , Xu          , Xu          , Xu          , Xu          , Xu          , Xu          , Xu          , Xu          
Xu          , Xu          , Xu          , Xu          , Xu          , Xu          , Xu          , Xu          , Uu^Uf       , Rr          , Xu          , Re          , Re          , Re          , Rr          , Rr          , Rd          , Rr          , Rr          , Re          , Re          , Re          , Xu          , Rr          , Uu          , Xu          , Xu          , Xu          , Xu          , Xu          , Xu          , Xu          , Xu          
Xu          , Xu          , Xu          , Xu          , Xu          , Xu          , Xu          , Xu          , Uu          , Rr          , Re          , Re          , Re          , Xu          , Rd          , Rd          , Xu          , Rd          , Rd          , Xu          , Re          , Re          , Re          , Rr          , Uu          , Xu          , Xu          , Xu          , Xu          , Xu          , Xu          , Xu          , Xu          
Xu          , Xu          , Xu          , Xu          , Xu          , Xu          , Xu          , Xu          , Dd^Dr       , Rr          , Re          , Uu^Ii       , Re          , Rr          , Uu^Vu       , Xu          , Xu          , Xu          , Uu^Vud      , Rr          , Re          , Uu^Ii       , Re          , Rr          , Uu          , Xu          , Xu          , Xu          , Xu          , Xu          , Xu          , Xu          , Xu          
Xu          , Xu          , Xu          , Xu          , Xu          , Xu          , Xu          , Xu          , Uu          , Rr          , Xu          , Re          , Xu          , Rr          , Rd          , Xu          , Xu          , Xu          , Rd          , Rr          , Xu          , Re          , Xu          , Rr          , Uu          , Xu          , Xu          , Xu          , Xu          , Xu          , Xu          , Xu          , Xu          
Xu          , Xu          , Xu          , Xu          , Xu          , Xu          , Xu          , Xu          , Uu          , Rr          , Re          , Re          , Re          , Rr          , Uu^Vu       , Xu          , Xu          , Xu          , Uu^Vud      , Rr          , Re          , Re          , Re          , Rr          , Uu^Uf       , Xu          , Xu          , Xu          , Xu          , Xu          , Xu          , Xu          , Xu          
Xu          , Xu          , Xu          , Xu          , Xu          , Xu          , Xu          , Xu          , Uu          , Rr          , Re          , Uu^Ii       , Re          , Rr          , Rd          , Xu          , Xu          , Xu          , Rd          , Rr          , Re          , Uu^Ii       , Re          , Xv          , Uu          , Xu          , Xu          , Xu          , Xu          , Xu          , Xu          , Xu          , Xu          
Xu          , Xu          , Xu          , Xu          , Xu          , Xu          , Xu          , Xu          , Uu^Uf       , Rr          , Xu          , Re          , Xu          , Rr          , Xv          , Xu          , Xu          , Xu          , Rd          , Rr          , Xu          , Re          , Xu          , Rr          , Uu          , Xu          , Xu          , Xu          , Xu          , Xu          , Xu          , Xu          , Xu          
Xu          , Xu          , Xu          , Xu          , Xu          , Xu          , Xu          , Xu          , Uu          , Xv          , Re          , Re          , Re          , Dd^Dr       , Rd          , Xu          , Xu          , Xu          , Rd          , Rr          , Dd^Dr       , Dd^Dr       , Re          , Rr          , Uu          , Xu          , Xu          , Xu          , Xu          , Xu          , Xu          , Xu          , Xu          
Xu          , Xu          , Xu          , Xu          , Xu          , Xu          , Xu          , Xu          , Uu^Uf       , Rr          , Re          , Dd^Dr       , Re          , Rr          , Uu^Vu       , Xu          , Xu          , Xu          , Uu^Vud      , Rr          , Re          , Uu^Ii       , Re          , Rr          , Uu          , Xu          , Xu          , Xu          , Xu          , Xu          , Xu          , Xu          , Xu          
Xu          , Xu          , Xu          , Xu          , Xu          , Xu          , Xu          , Xu          , Uu          , Rr          , Xu          , Re          , Xu          , Rr          , Rd          , Xu          , Xu          , Xu          , Rd          , Rr          , Xu          , Re          , Xu          , Dd^Dr       , Uu^Uf       , Xu          , Xu          , Xu          , Xu          , Xu          , Xu          , Xu          , Xu          
Xu          , Xu          , Xu          , Xu          , Xu          , Xu          , Xu          , Xu          , Xv          , Xv          , Re          , Re          , Dd^Dr       , Rr          , Uu^Vu       , Xu          , Xu          , Xu          , Uu^Vud      , Rr          , Re          , Re          , Re          , Rr          , Uu^Uf       , Xu          , Xu          , Xu          , Xu          , Xu          , Xu          , Xu          , Xu          
Xu          , Xu          , Xu          , Xu          , Xu          , Xu          , Xu          , Xu          , Uu          , Dd^Dr       , Re          , Uu^Ii       , Re          , Rr          , Rd          , Xu          , Xu          , Xu          , Rd          , Rr          , Re          , Uu^Ii       , Re          , Rr          , Uu          , Xu          , Xu          , Xu          , Xu          , Xu          , Xu          , Xu          , Xu          
Xu          , Xu          , Xu          , Xu          , Xu          , Xu          , Xu          , Xu          , Xu          , Uu          , Uu          , Re          , Re          , Rr          , Rd          , Xu          , Xu          , Xu          , Rd          , Rr          , Re          , Re          , Uu          , Xv          , Xu          , Xu          , Xu          , Xu          , Xu          , Xu          , Xu          , Xu          , Xu          
Xu          , Xu          , Xu          , Xu          , Xu          , Xu          , Xu          , Xu          , Xu          , Xu          , Xu          , Uu          , Uu          , Re          , Re          , Rd          , Re          , Rd          , Re          , Re          , Uu          , Uu          , Xu          , Xu          , Xu          , Xu          , Xu          , Xu          , Xu          , Xu          , Xu          , Xu          , Xu          
Xu          , Xu          , Xu          , Xu          , Xu          , Xu          , Xu          , Xu          , Xu          , Xu          , Xu          , Xu          , Xu          , Xu          , Rr          , Re          , Uu^Ii       , Re          , Rr          , Xu          , Xu          , Xu          , Xu          , Xu          , Xu          , Xu          , Xu          , Xu          , Xu          , Xu          , Xu          , Xu          , Xu          
Xu          , Xu          , Xu          , Xu          , Xu          , Xu          , Xu          , Xu          , Xu          , Xu          , Xu          , Xu          , Xu          , Rr          , Gg^Vh       , Ch          , 1 Kh        , Ch          , Gg^Vh       , Rr          , Xu          , Xu          , Xu          , Xu          , Xu          , Xu          , Xu          , Xu          , Xu          , Xu          , Xu          , Xu          , Xu          
Xu          , Xu          , Xu          , Xu          , Xu          , Xu          , Xu          , Xu          , Xu          , Xu          , Xu          , Xu          , Xu          , Rr          , Gg^Vh       , Ch          , Ch          , Ch          , Gg^Vh       , Rr          , Xu          , Xu          , Xu          , Xu          , Xu          , Xu          , Xu          , Xu          , Xu          , Xu          , Xu          , Xu          , Xu          
Xu          , Xu          , Xu          , Xu          , Xu          , Xu          , Xu          , Xu          , Xu          , Xu          , Xu          , Xu          , Xu          , Rr          , Rr          , Rr          , Rr          , Rr          , Rr          , Rr          , Xu          , Xu          , Xu          , Xu          , Xu          , Xu          , Xu          , Xu          , Xu          , Xu          , Xu          , Xu          , Xu          
