border_size=1
usage=map

Xu          , Xu          , Xu          , Xu          , Xu          , Xu          , Xu          , Xu          , Xu          , Xu          , Xu          , Xu          , Xu          , Xu          , Xu          , Xu          , Xu          , Xu          , Xu          , Xu          , Xu          , Xu          , Xu          , Xu          , Xu          , Xu          , Xu          , Xu          , Xu          , Xu          , Xu          , Xu          , Xu          
Xu          , Xu          , Xu          , Xu          , Xu          , Xu          , Xu          , Xu          , Xu          , Xu          , Xu          , Xu          , Xu          , Xu          , Xu          , Xu          , Gg^Vc       , Xu          , Xu          , Xu          , Xu          , Xu          , Xu          , Xu          , Xu          , Xu          , Xu          , Xu          , Xu          , Xu          , Xu          , Xu          , Xu          
Xu          , Xu          , Qlf         , Qlf         , Rd          , Rr          , Uh^Ii       , Rr          , Uu^Tf       , Rr          , Rd          , Rr          , Rd          , Rr          , Wwf         , Rr          , Wwf         , Rr          , Rr          , Gg^Vc       , Rd          , Rr          , Ww          , Rr          , Rr          , Rr          , Ww          , Ww          , Rr          , Rr          , Rr          , Xu          , Xu          
Xu          , Xu          , Qlf         , Xv          , Xv          , Rd          , Rr          , Uu^Tf       , Rd          , Rd          , Rr          , Rd          , Rr          , Rd          , Wwf         , Wwf         , Ss          , Wwf         , Wwf         , Rr          , Rd          , Rr          , Rd          , Rr          , Uu^Tf       , Rd          , Rr          , Rd          , Rd          , Uh          , Rr          , Xu          , Xu          
Xu          , Xu          , Qlf         , Uh^Ii       , Xv          , Rd          , Rd          , Rd          , Dd^Dr       , Uh          , Re^Tf       , Ww          , Ww          , Wwf         , Cud         , Ss          , Dd^Dr       , Wwf         , Ss          , Aa          , Uh          , Rd          , Uh          , Ww          , Rr          , Ww          , Uh          , Uh          , Ww          , Uu^Tf       , Uu^Tf       , Xu          , Xu          
Xu          , Xu          , Qlf         , Uh^Ii       , Xv          , Rp          , Xv          , Rr          , Aa^Vea      , Re^Tf       , Aa          , Rr          , Ww          , Cud         , 2 Kud       , Cud         , Dd^Dr       , Dd^Dr       , Aa          , Aa          , Rr          , Uh          , Rr          , Uh          , Re^Tf       , Rr          , Ss          , Rr          , Re^Tf       , Re^Tf       , Uu^Tf       , Xu          , Xu          
Xu          , Xu          , Re^Tf       , Qlf         , Re^Tf       , Xv          , Re^Tf       , Rd          , Uu^Tfi      , Aa          , Aa          , Rr          , Uh          , Cud         , Cud         , Cud         , Re^Tf       , Aa          , Rp          , Rr          , Uu^Tfi      , Uu^Tf       , Ww          , Re^Tf       , Re^Tf       , Re^Tf       , Dd^Dr       , Rr          , Re^Tf       , Rr          , Ww          , Xu          , Xu          
Xu          , Xu          , Rr          , Re^Tf       , Uh          , Re^Tf       , Re^Tf       , Uu^Tfi      , Rr          , Dd^Dr       , Uh          , Uh^Ii       , Uh          , Rr          , Rr          , Rr          , Re^Tf       , Rp          , Xv          , Xv          , Uu^Tfi      , Uu^Tf       , Rp          , Rr          , Rr          , Ss          , Wwf         , Aa          , Rr          , Ww          , Rd          , Xu          , Xu          
Xu          , Xu          , Rr          , Uh          , Uh          , Uh          , Rr          , Ww          , Ww          , Rr          , Rp          , Rr          , Qlf         , Re^Tf       , Re^Tf       , Rr          , Rd          , Rp          , Rr          , Ww          , Ww          , Rr          , Ww          , Rr          , Ss^Vhs      , Wwf         , Aa          , Aa          , Rr          , Rd          , Xv          , Xu          , Xu          
Xu          , Xu          , Rr          , Xv          , Xv          , Re^Tf       , Xv          , Rr          , Rr          , Ww          , Rd          , Qlf         , Rr          , Re^Tf       , Rd          , Rd          , Rr          , Uh^Ii       , Qlf         , Qlf         , Qlf         , Rr          , Rr          , Rr          , Wwf         , Wwf         , Wwf         , Aa          , Uh          , Rd          , Xv          , Xu          , Xu          
Xu          , Xu          , Rr          , Re^Tf       , Xv          , Xv          , Xv          , Uu^Tfi      , Aa          , Aa          , Uh          , Qlf         , Rr          , Re^Tf       , Rr          , Rr          , Re^Tf       , Uh^Ii       , Qlf         , Qlf         , Qlf         , Qlf         , Rr          , Dd^Dr       , Rr          , Rr          , Dd^Dr       , Rr          , Uh          , Xv          , Rd          , Xu          , Xu          
Xu          , Xu          , Rp          , Rr          , Uh^Ii       , Uh^Ii       , Uu^Tf       , Uu^Tfi      , Aa          , Aa          , Uh^Ii       , Rr          , Ww          , Re^Tf       , Ss          , Ss^Vhs      , Rr          , Re^Tf       , Re^Tf       , Re^Tf       , Rr          , Ww          , Uu^Tf       , Rr          , Rd          , Rr          , Qlf         , Uh          , Uh          , Rr          , Rd          , Xu          , Xu          
Xu          , Xu          , Rr          , Rp          , Aa          , Aa          , Aa          , Uu^Tfi      , Wwf         , Wwf         , Ww          , Xv          , Ww          , Rr          , Ss          , Wwf         , Rd          , Rd          , Rr          , Rr          , Ww          , Ww          , Rd          , Rd          , Re^Tf       , Rd          , Rr          , Uh          , Ww          , Rr          , Rr          , Xu          , Xu          
Xu          , Xu          , Ss          , Rp          , Ss          , Rr          , Cud         , Qlf         , Qlf         , Uu^Tf       , Rd          , Xv          , Rd          , Wwf         , Uu^Tfi      , Rd          , Rr          , Rr          , Re^Tf       , Rr          , Ww          , Rr          , Uu^Tf       , Re^Tf       , Aa          , Qlf         , Rr          , Rr          , Rr          , Ww          , Rr          , Xu          , Xu          
Xu          , Xu          , Aa          , Ss          , Aa          , Cud         , 4 Kud       , Cud         , Uu^Tf       , Uu^Tf       , Ss^Vhs      , Xv          , Rr          , Rp          , Rp          , Uu^Tfi      , Aa          , Re^Tf       , Rr          , Rr          , Uu^Vud      , Uu^Tf       , Uh          , Rr          , Rr          , Rr          , Rr          , Aa          , Re^Tf       , Uh          , Rr          , Xu          , Xu          
Xu          , Xu          , Aa          , Aa          , Rd          , Cud         , Cud         , Cud         , Ss          , Ss          , Wwf         , Wwf         , Uu^Tf       , Rr          , Qlf         , Rp          , Rr          , Aa          , Rr          , Rr          , Uh          , Uh          , Rd          , Uh          , Uh          , Rr          , Rd          , Rr          , Rr          , Re^Tf       , Rr          , Xu          , Xu          
Xu          , Xu          , Ss          , Aa          , Rd          , Uh          , Ss          , Ss          , Rr          , Rr          , Wwf         , Uu^Tf       , Uu^Tf       , Qlf         , Uu^Tf       , Qlf         , Rr          , Aa^Vea      , Aa          , Uu^Tfi      , Uh          , Rd          , Dd^Dr       , Rr          , Rr          , Rr          , Wwf         , Rd          , Rd          , Rr          , Rr          , Xu          , Xu          
Xu          , Xu          , Rr          , Ss          , Qlf         , Rd          , Ss^Vhs      , Rr          , Rr          , Dd^Dr       , Dd^Dr       , Rr          , Uu^Tf       , Uu^Tf       , Re^Tf       , Rr          , Rr          , Aa          , Aa          , Uu^Tfi      , Rp          , Uh          , Wwf         , Rr          , Rr          , Dd^Dr       , Rr          , Rd          , Qlf         , Rr          , Rr          , Xu          , Xu          
Xu          , Xu          , Rr          , Ss          , Rr          , Rp          , Uh          , Rr          , Rd          , Rr          , Rd          , Ww          , Rr          , Rr          , Re^Tf       , Re^Tf       , Re^Tf       , Rr          , Wwf         , Rp          , Wwf         , Wwf         , Ss          , Re^Tf       , Re^Tf       , Uh          , Re^Tf       , Rd          , Qlf         , Rr          , Rr          , Xu          , Xu          
Xu          , Xu          , Uh          , Ss          , Ww          , Rp          , Re^Tf       , Aa          , Rr          , Rd          , Rd          , Rd          , Rd          , Rr          , Rr          , Rr          , Uu^Tfi      , Qlf         , Rr          , Wwf         , Aa          , Ss          , Rp          , Rp          , Re^Tf       , Rr          , Re^Tf       , Rd          , Rr          , Qlf         , Rr          , Xu          , Xu          
Xu          , Xu          , Uh          , Rr          , Ww          , Dd^Dr       , Re^Tf       , Rr          , Wwf         , Wwf         , Re^Tf       , Rd          , Xv          , Ss          , Uu^Tf       , Uu^Tfi      , Uh^Ii       , Qlf         , Qlf         , Aa          , Aa          , Ss          , Ss^Vhs      , Aa^Vea      , Rr          , Rr          , Cud         , Xv          , Uh^Ii       , Qlf         , Uh          , Xu          , Xu          
Xu          , Xu          , Rr          , Ss          , Uh^Ii       , Rr          , Re^Tf       , Rr          , Dd^Dr       , Re^Tf       , Xv          , Xv          , Dd^Dr       , Uu^Tf       , Uu^Tf       , Rr          , Rd          , Uh          , Xv          , Aa          , Rr          , Wwf         , Wwf         , Re^Tf       , Re^Tf       , Cud         , 3 Kud       , Cud         , Ss          , Uh^Ii       , Uh          , Xu          , Xu          
Xu          , Xu          , Rr          , Ss          , Uh^Ii       , Wwf         , Rr          , Ss          , Rr          , Re^Tf       , Rr          , Ss          , Uu^Tfi      , Wwf         , Rr          , Ss          , Rr          , Rd          , Rr          , Rp          , Rp          , Dd^Dr       , Rr          , Re^Tf       , Rd          , Cud         , Cud         , Cud         , Dd^Dr       , Ss          , Ss          , Xu          , Xu          
Xu          , Xu          , Ss          , Ss          , Qlf         , Uh^Ii       , Rr          , Ss          , Uh^Ii       , Uu^Vud      , Uh          , Rr          , Aa          , Wwf         , Wwf         , Rr          , Ss          , Re^Tf       , Re^Tf       , Rp          , Rp          , Rp          , Rr          , Rd          , Rd          , Wwf         , Ss          , Aa          , Aa          , Aa          , Xu          , Xu          , Xu          
Xu          , Xu          , Rr          , Ss          , Rr          , Qlf         , Re^Tf       , Uh          , Rp          , Uh          , Rd          , Rd          , Aa^Vea      , Aa          , Rr          , Wwf         , Wwf         , Rr          , Re^Tf       , Re^Tf       , Uh          , Ww          , Ww          , Re^Tf       , Dd^Dr       , Wwf         , Ss          , Aa          , Xu          , Xu          , Ss          , Ss          , Xu          
Xu          , Xu          , Xu          , Rr          , Uu^Tf       , Re^Tf       , Rp          , Dd^Dr       , Rp          , Xv          , Dd^Dr       , Rd          , Uh          , Aa          , Ww          , Ww          , Ww^Vm       , Rr          , Uu^Tf       , Re^Tf       , Rp          , Ww          , Re^Tf       , Rp          , Rr          , Ss          , Xu          , Xu          , Ss          , Ss          , Ss          , Ss          , Xu          
Xu          , Ss          , Ss          , Xu          , Xu          , Re^Tf       , Re^Tf       , Rp          , Re^Tf       , Qlf         , Qlf         , Uh          , Xu          , Rr          , Rd          , Rr          , Rd          , Rr          , Xu          , Rp          , Uh^Ii       , Ww          , Rr          , Rr          , Xu          , Xu          , Ss          , Ss          , Dd^Dr       , Ss          , Xu          , Xu          , Xu          
Xu          , Ss          , Rr          , Ss          , Dd^Dr       , Xu          , Xu          , Re^Tf       , Qlf         , Qlf         , Xu          , Xu          , Rr          , Rr          , Dd^Dr       , Rr          , Rr          , Rr          , Wwf         , Xu          , Xu          , Uh          , Xu          , Xu          , Rr          , Dd^Dr       , Ss          , Ss          , Xu          , Xu          , Xu          , Xu          , Xu          
Xu          , Xu          , Xu          , Rr          , Rr          , Rr          , Rr          , Xu          , Xu          , Xu          , Uu^Tf       , Rr          , Wwf         , Rr          , Uu^Tf       , Rr          , Ss          , Wwf         , Rr          , Rr          , Rr          , Xu          , Rr          , Xv          , Ss          , Ss          , Xu          , Xu          , Xu          , Xu          , Xu          , Xu          , Xu          
Xu          , Xu          , Xu          , Xu          , Xu          , Rr          , Ss          , Rr          , Rr          , Rr          , Uu^Tf       , Uu^Tf       , Ss          , Wwf         , Wwf         , Rd          , Gg^Ve       , Ss          , Ss          , Ss          , Ss          , Rr          , Uu^Tf       , Rr          , Uu          , Xu          , Xu          , Xu          , Xu          , Xu          , Xu          , Xu          , Xu          
Xu          , Xu          , Xu          , Xu          , Xu          , Xu          , Xu          , Rr          , Uu          , Uu^Tf       , Dd^Dr       , Rr          , Rr          , Ss          , Ss          , Re          , Uu^Ii       , Re          , Xu          , Rr          , Xv          , Rr          , Uu^Tf       , Rr          , Uu          , Xu          , Xu          , Xu          , Xu          , Xu          , Xu          , Xu          , Xu          
Xu          , Xu          , Xu          , Xu          , Xu          , Xu          , Xu          , Xu          , Uu          , Rr          , Dd^Dr       , Rr          , Re          , Xu          , Re          , Re          , Re          , Re          , Re          , Rr          , Re          , Uu^Tf       , Rr          , Dd^Dr       , Uu          , Xu          , Xu          , Xu          , Xu          , Xu          , Xu          , Xu          , Xu          
Xu          , Xu          , Xu          , Xu          , Xu          , Xu          , Xu          , Xu          , Uu          , Rr          , Rr          , Dd^Dr       , Uu^Ii       , Re          , Rr          , Xu          , Rr          , Xu          , Rr          , Re          , Uu^Ii       , Dd^Dr       , Rr          , Rr          , Uu^Tf       , Xu          , Xu          , Xu          , Xu          , Xu          , Xu          , Xu          , Xu          
Xu          , Xu          , Xu          , Xu          , Xu          , Xu          , Xu          , Xu          , Uu^Tf       , Rr          , Xu          , Re          , Re          , Re          , Rr          , Rr          , Rd          , Rr          , Rr          , Re          , Re          , Re          , Xu          , Rr          , Uu          , Xu          , Xu          , Xu          , Xu          , Xu          , Xu          , Xu          , Xu          
Xu          , Xu          , Xu          , Xu          , Xu          , Xu          , Xu          , Xu          , Uu          , Rr          , Re          , Re          , Re          , Xu          , Rd          , Rd          , Xu          , Rd          , Rd          , Xu          , Re          , Re          , Re          , Rr          , Uu          , Xu          , Xu          , Xu          , Xu          , Xu          , Xu          , Xu          , Xu          
Xu          , Xu          , Xu          , Xu          , Xu          , Xu          , Xu          , Xu          , Dd^Dr       , Rr          , Re          , Uu^Ii       , Re          , Rr          , Uu^Vu       , Xu          , Xu          , Xu          , Uu^Vud      , Rr          , Re          , Uu^Ii       , Re          , Rr          , Uu          , Xu          , Xu          , Xu          , Xu          , Xu          , Xu          , Xu          , Xu          
Xu          , Xu          , Xu          , Xu          , Xu          , Xu          , Xu          , Xu          , Uu          , Rr          , Xu          , Re          , Xu          , Rr          , Rd          , Xu          , Xu          , Xu          , Rd          , Rr          , Xu          , Re          , Xu          , Rr          , Uu          , Xu          , Xu          , Xu          , Xu          , Xu          , Xu          , Xu          , Xu          
Xu          , Xu          , Xu          , Xu          , Xu          , Xu          , Xu          , Xu          , Uu          , Rr          , Re          , Re          , Re          , Rr          , Uu^Vu       , Xu          , Xu          , Xu          , Uu^Vud      , Rr          , Re          , Re          , Re          , Rr          , Uu^Tf       , Xu          , Xu          , Xu          , Xu          , Xu          , Xu          , Xu          , Xu          
Xu          , Xu          , Xu          , Xu          , Xu          , Xu          , Xu          , Xu          , Uu          , Rr          , Re          , Uu^Ii       , Re          , Rr          , Rd          , Xu          , Xu          , Xu          , Rd          , Rr          , Re          , Uu^Ii       , Re          , Xv          , Uu          , Xu          , Xu          , Xu          , Xu          , Xu          , Xu          , Xu          , Xu          
Xu          , Xu          , Xu          , Xu          , Xu          , Xu          , Xu          , Xu          , Uu^Tf       , Rr          , Xu          , Re          , Xu          , Rr          , Xv          , Xu          , Xu          , Xu          , Rd          , Rr          , Xu          , Re          , Xu          , Rr          , Uu          , Xu          , Xu          , Xu          , Xu          , Xu          , Xu          , Xu          , Xu          
Xu          , Xu          , Xu          , Xu          , Xu          , Xu          , Xu          , Xu          , Uu          , Xv          , Re          , Re          , Re          , Dd^Dr       , Rd          , Xu          , Xu          , Xu          , Rd          , Rr          , Dd^Dr       , Dd^Dr       , Re          , Rr          , Uu          , Xu          , Xu          , Xu          , Xu          , Xu          , Xu          , Xu          , Xu          
Xu          , Xu          , Xu          , Xu          , Xu          , Xu          , Xu          , Xu          , Uu^Tf       , Rr          , Re          , Dd^Dr       , Re          , Rr          , Uu^Vu       , Xu          , Xu          , Xu          , Uu^Vud      , Rr          , Re          , Uu^Ii       , Re          , Rr          , Uu          , Xu          , Xu          , Xu          , Xu          , Xu          , Xu          , Xu          , Xu          
Xu          , Xu          , Xu          , Xu          , Xu          , Xu          , Xu          , Xu          , Uu          , Rr          , Xu          , Re          , Xu          , Rr          , Rd          , Xu          , Xu          , Xu          , Rd          , Rr          , Xu          , Re          , Xu          , Dd^Dr       , Uu^Tf       , Xu          , Xu          , Xu          , Xu          , Xu          , Xu          , Xu          , Xu          
Xu          , Xu          , Xu          , Xu          , Xu          , Xu          , Xu          , Xu          , Xv          , Xv          , Re          , Re          , Dd^Dr       , Rr          , Uu^Vu       , Xu          , Xu          , Xu          , Uu^Vud      , Rr          , Re          , Re          , Re          , Rr          , Uu^Tf       , Xu          , Xu          , Xu          , Xu          , Xu          , Xu          , Xu          , Xu          
Xu          , Xu          , Xu          , Xu          , Xu          , Xu          , Xu          , Xu          , Uu          , Dd^Dr       , Re          , Uu^Ii       , Re          , Rr          , Rd          , Xu          , Xu          , Xu          , Rd          , Rr          , Re          , Uu^Ii       , Re          , Rr          , Uu          , Xu          , Xu          , Xu          , Xu          , Xu          , Xu          , Xu          , Xu          
Xu          , Xu          , Xu          , Xu          , Xu          , Xu          , Xu          , Xu          , Xu          , Uu          , Uu          , Re          , Re          , Rr          , Rd          , Xu          , Xu          , Xu          , Rd          , Rr          , Re          , Re          , Uu          , Xv          , Xu          , Xu          , Xu          , Xu          , Xu          , Xu          , Xu          , Xu          , Xu          
Xu          , Xu          , Xu          , Xu          , Xu          , Xu          , Xu          , Xu          , Xu          , Xu          , Xu          , Uu          , Uu          , Re          , Re          , Rd          , Re          , Rd          , Re          , Re          , Uu          , Uu          , Xu          , Xu          , Xu          , Xu          , Xu          , Xu          , Xu          , Xu          , Xu          , Xu          , Xu          
Xu          , Xu          , Xu          , Xu          , Xu          , Xu          , Xu          , Xu          , Xu          , Xu          , Xu          , Xu          , Xu          , Xu          , Rr          , Re          , Uu^Ii       , Re          , Rr          , Xu          , Xu          , Xu          , Xu          , Xu          , Xu          , Xu          , Xu          , Xu          , Xu          , Xu          , Xu          , Xu          , Xu          
Xu          , Xu          , Xu          , Xu          , Xu          , Xu          , Xu          , Xu          , Xu          , Xu          , Xu          , Xu          , Xu          , Rr          , Gg^Vh       , Ch          , 1 Kh        , Ch          , Gg^Vh       , Rr          , Xu          , Xu          , Xu          , Xu          , Xu          , Xu          , Xu          , Xu          , Xu          , Xu          , Xu          , Xu          , Xu          
Xu          , Xu          , Xu          , Xu          , Xu          , Xu          , Xu          , Xu          , Xu          , Xu          , Xu          , Xu          , Xu          , Rr          , Gg^Vh       , Ch          , Ch          , Ch          , Gg^Vh       , Rr          , Xu          , Xu          , Xu          , Xu          , Xu          , Xu          , Xu          , Xu          , Xu          , Xu          , Xu          , Xu          , Xu          
Xu          , Xu          , Xu          , Xu          , Xu          , Xu          , Xu          , Xu          , Xu          , Xu          , Xu          , Xu          , Xu          , Rr          , Rr          , Rr          , Rr          , Rr          , Rr          , Rr          , Xu          , Xu          , Xu          , Xu          , Xu          , Xu          , Xu          , Xu          , Xu          , Xu          , Xu          , Xu          , Xu          
