border_size=1
usage=map

Gg          , Gg          , Gg          , Gg          , Gg          , Ch          , Ch          , Ch          , Ch          , Rr          , Rr          , Rr          , Rr          , Rr          , Ch          , Ch          , Ch          , Ch          , Gg          , Gg          , Gg          , Gg          , Gg          
Gg          , Gg          , Re^Gvs      , Gg          , Gg^Wm       , Gg          , Gg          , Ch          , Ch          , Rr          , Rr          , 1 Rr        , Rr          , Rr          , Ch          , Ch          , Gg          , Gg^Vh       , Gg          , Re^Gvs      , Re^Gvs      , Gg          , Gg          
Gg          , Re^Gvs      , Re^Gvs      , Re^Gvs      , Re^Gvs      , Gg          , Gg          , Gg          , Rd          , Rr          , Rr          , Rr          , Rr          , Rr          , Rd          , Gg          , Gg          , Gg          , Re^Gvs      , Re^Gvs      , Re^Gvs      , Gg          , Gg          
Gg          , Re^Gvs      , Re^Gvs      , Re^Gvs      , Gg          , Gg          , Gg          , Gg          , Rd          , Rr          , Rr          , 2 Rr        , Rr          , Rr          , Rd          , Gg          , Gg          , Gg          , Gg          , Re^Gvs      , Re^Gvs      , Gg          , Gg          
Gg          , Gg          , Re^Gvs      , Re^Gvs      , Gg          , Gg          , Gg          , Gg          , Rd          , Rr          , Rr          , Rr          , Rr          , Rr          , Rd          , Gg          , Gg          , Gg          , Gg          , Gg          , Gg          , Gg          , Gg          
Gg          , Gg          , Gg          , Gg          , Rd          , Gg          , Gg          , Gg          , Rd          , Rr          , Rr          , Rr          , Rr          , Rr          , Rd          , Gg          , Gg          , Gg          , Gg          , Gg          , Gg          , Gg          , Gg          
Gg          , Gg          , Gg          , Gg          , Rd          , Gg          , Gg          , Gg          , Ch          , Rr          , Rr          , Rr          , Rr          , Rr          , Ch          , Gg          , Gg          , Gg          , Gg          , Gg          , Rd          , Gg          , Gg          
Gg          , Gg          , Gg          , Gg          , Rd          , Rd          , Gg          , Gg          , Rd          , Rr          , Rr          , Rr          , Rr          , Rr          , Rd          , Gg          , Gg          , Gg          , Gg          , Rd          , Rd          , Gg          , Gg          
Gg          , Gg          , Gg          , Gg          , Rd          , Gg          , Gg          , Gg          , Rd          , Rr          , Rr          , Rr          , Rr          , Rr          , Rd          , Gg          , Gg          , Gg          , Re^Gvs      , Re^Gvs      , Gg          , Gg          , Gg          
Gg          , Gg          , Gg          , Rd          , Gg^Vh       , Gg          , Gg          , Gg          , Rd          , Rr          , Rr          , Rr          , Rr          , Rr          , Rd          , Gg          , Gg          , Gg          , Re^Gvs      , Re^Gvs      , Gg^Vh       , Gg          , Gg          
Gg          , Gg          , Gg          , Gg          , Re^Gvs      , Gg          , Gg          , Gg          , Rd          , Rr          , Rr          , Rr          , Rr          , Rr          , Rd          , Rd          , Gg          , Gg          , Gg          , Gg          , Gg          , Gg          , Gg          
Gg          , Gg          , Re^Gvs      , Re^Gvs      , Re^Gvs      , Re^Gvs      , Gg          , Gg          , Rd          , Rr          , Rr          , Rr          , Rr          , Rr          , Rd          , Gg          , Gg          , Gg          , Gg          , Re^Gvs      , Re^Gvs      , Gg          , Gg          
Gg          , Gg          , Gg          , Re^Gvs      , Re^Gvs      , Gg          , Gg          , Gg          , Ch          , Rr          , Rr          , Rr          , Rr          , Rr          , Ch          , Gg          , Gg          , Gg          , Gg          , Re^Gvs      , Re^Gvs      , Gg          , Gg          
Gg          , Gg          , Gg          , Re^Gvs      , Re          , Gg          , Gg          , Gg          , Rd          , Rr          , Rr          , Rr          , Rr          , Rr          , Rd          , Gg          , Gg          , Gg^Wm       , Re^Gvs      , Re^Gvs      , Gg          , Gg          , Gg          
Gg          , Gg          , Gg          , Re^Gvs      , Gg          , Gg          , Gg          , Rd          , Rd          , Rr          , Rr          , Rr          , Rr          , Rr          , Rd          , Rd          , Gg          , Gg          , Gg          , Re          , Re          , Gg          , Gg          
Gg          , Gg          , Gg^Vh       , Gg          , Gg          , Gg          , Gg          , Gg          , Rd          , Rr          , Rr          , Rr          , Rr          , Rr          , Rd          , Rd          , Gg          , Gg          , Gg          , Gg          , Gg          , Gg          , Gg          
Gg          , Gg          , Gg          , Gg          , Gg          , Gg          , Gg          , Gg          , Rd          , Rr          , Rr          , Rr          , Rr          , Rr          , Rd          , Rd          , Gg          , Gg          , Gg          , Gg          , Gg          , Re          , Gg          
Gg          , Gg          , Re^Gvs      , Gg          , Gg          , Gg          , Gg          , Gg          , Rd          , Rr          , Rr          , Rr          , Rr          , Rr          , Rd          , Rd          , Gg          , Gg          , Gg^Vh       , Re^Gvs      , Re^Gvs      , Re          , Gg          
Gg          , Re^Gvs      , Re^Gvs      , Re^Gvs      , Re^Gvs      , Re^Gvs      , Gg          , Gg          , Rd          , Rr          , Rr          , Rr          , Rr          , Rr          , Rd          , Gg          , Gg          , Gg          , Gg          , Re^Gvs      , Re^Gvs      , Gg          , Gg          
Gg          , Gg          , Re^Gvs      , Re^Gvs      , Gg          , Gg          , Gg          , Gg          , Ch          , Rr          , Rr          , Rr          , Rr          , Rr          , Ch          , Gg          , Gg          , Gg          , Re^Gvs      , Re^Gvs      , Re^Gvs      , Re^Gvs      , Gg          
Gg          , Gg          , Gg          , Gg          , Gg          , Gg          , Gg          , Gg          , Rd          , Rr          , Rr          , Rr          , Rr          , Rr          , Rd          , Gg          , Gg          , Gg          , Gg          , Gg          , Gg          , Gg          , Gg          
Gg          , Gg          , Gg          , Gg          , Gg          , Gg          , Gg          , Rd          , Rd          , Rr          , Rr          , Rr          , Rr          , Rr          , Rd          , Gg          , Gg          , Gg          , Gg          , Gg          , Gg          , Gg          , Gg          
